conhecimento	escola
indolente	omisso
canhambola	quilombola
constante	freqüente
pretender	visar
calar	mentir
passadio	vivenda
fixar	mandar
bandear-se	passar-se
persigal	presepe
agoirar	profetizar
lembrar-se	relembrar-se
aproximar-se	puxar
amortecer-se	esmaecer
cerrar-se	encangotar-se
falência	falimento
anátema	excomungação
sobreexcedido	ultrapassado
carrancudo	sobrancelhudo
gatear	rapinhar
consolador	solaz
bastonada	bordoada
assombrar	assustar
firme	segurado
caluniar	desonestar
columbino	virgem
diluir	moderar
agência	diligência
deposição	destronização
desembuçar	respirar
afiar	esmerilar
apoiar	laurear
firmeza	seguridade
gastar-se	ir-se
aprumar-se	perfilar-se
abstruso	esconso
agitar	desassossegar
depreciar	desfavorecer
base	fundação
precatadamente	prevenidamente
alardear-se	gargantear
pequeno	pequerrucho
pundonoroso	reto
desenxabimento	mornidão
acabar	executar
esticar	inteiriçar
caronear	desvairar
endoidecer	endoudar
algazarra	babel
pressuposto	pretexto
progressão	progresso
espicaçar	magoar
arrojado	intérrito
enlear	enredar
luxurioso	obsceno
desabotinado	estoirado
comandar	conduzir
apagar	debotar
contar	dizer
maciar	mitigar
desvanecer	varrer
banhar-se	lavar-se
aparado	aposto
afetível	simpático
desaparecer-se	perder-se
açoiteira	chicote
carteira	escrivaninha
apontar	extravasar
amarfanhar	torturar
adelgaçar	engoiar-se
molecada	pirralhada
extravasar	redundar
descapacitar-se	desimaginar-se
silencioso	taciturno
ascoroso	nauseabundo
destinar	empregar
elucidar	explicar
pandilha	pandilheiro
ceder	diminuir
migalha	migalho
refrear-se	vencer-se
amolar	massacrar
aprisionar	pegar
palatal	palatinal
insuperável	invencível
infindo	infinito
alegre	travesso
rateio	repartição
enfatuamento	entufamento
espanar	espoar
asselvajado	rude
aldeia	póvoa
subtilidade	talento
amontoar	conglobar
acontecimento	evento
aspecto	traço
patrono	protetor
obsediar	rascar
denunciar	revelar
desadorar	intoxicar
apisoar	suplantar
atinado	ponderado
deportado	êxule
desavergonhado	petulante
afrouxar	malear
malcontente	triste
mazanza	zopeiro
alfaiado	engalanado
deslisar	turibular
alúvio	inundação
cacerenga	caxirenguengue
doca	zerê
arribana	rancho
colorear	sazonar
eremita	ermita
encurvar-se	prostrar-se
brilhantismo	majestade
arreado	empenado
desperdiçante	esperdiçante
traça	traçado
desonestar	infamar
sugerir	suscitar
alentado	encorajado
hora	tempo
encasamento	engrenamento
decaída	decaimento
embrenhar-se	fundir-se
descurar	desleixar
cingir	coagir
excelência	magnificência
flagelação	martirização
execrável	trasvisto
abrigar	garantir
desenlambuzar	mundificar
nauseante	nauseoso
galardoar	pagar
escusar-se	ressalvar-se
roubar	sonegar
sandio	tolo
aformosear	embrincar
dividir	ratear
transferir	transpassar
alquebrado	debilitado
idéia	mente
aplicar	empregar
desflorescimento	fenecimento
alanhar	ansiar
luzir	prefulgir
atarraxar	tarraxar
rever-se	ver-se
dignidade	gravidade
iludir	velhaquear
acobardado	atemorado
modicar	sopitar
gastador	perdulário
acordar	concitar
lapidificação	petrificação
admirado	banzado
cerzir	intervalar
prorrogar-se	protrair-se
apezinhar	desconsiderar
extravagante	incrível
azoretar	estontecer
esplender	resplender
atraiçoado	engazopado
desfechar	finalizar
botar	embotar
garotar	vagamundear
consternação	pesadume
exoneração	isenção
aluir	dirruir
entranqueirar	fortificar
encher	enquizilar
assoberbante	fatigante
cadaveroso	mortuoso
rabo	rasto
adversidade	contratempo
afiambrar	galanear
pilhar	saquear
fumarar	vaporar
abodegar	enquizilar
apoquentar	causticar
acerbidade	austeridade
devorar	dilapidar
destoante	malsoante
esporada	ferroada
animoso	brioso
extra-sensível	ultra-sensível
escolher	seletar
lançar	projetar
endeusar-se	enfunar-se
alto	exímio
cediço	prosaico
desvanecer-se	garguitear
desmodorrar	excitar
concepção	formulação
coruscar	lustrar
chocho	pacóvio
haraganar	preguiçar
correto	probo
pejado	vergonhoso
afeiar	desguarnecer
extraordinário	invulgar
esvaecer	expungir
fiscalizar	patrulhar
baldio	improducente
balcedoso	lameirento
apascentar-se	folgazar
azoeirado	embaraçado
alojamento	instalação
deitar	pôr
desmelhorar	minar
encostar	zurzir
exalar	externar-se
gatimonha	micagem
embalançar	menear
arranhão	raspão
ainda	demais
comer	nutrir-se
bambalhão	preguicento
afastar	retirar
auricomado	aurícomo
entenebrecer	sombrear
desassombrado	foito
amadurar-se	amadurecer-se
antitético	oposto
compor	unir
acasmurrado	porfiado
adiposidade	corpulência
investigar	perquirir
devoção	entrega
agradável	macio
septuagenário	setuagenário
adereçado	aparamentado
fabuloso	quimérico
apavorar	espavorizar
capengante	carapé
agastadiço	tomadiço
apodrecer	desconsertar
fortalecer-se	renovar-se
cativante	sedutor
desencontrar	dissentir
noitada	noutada
desbravar	domesticar
versejar	versificar
compungir	entristecer
carregado	intenso
prescrição	provisão
agenda	caderneta
enaltar	levantar
afouto	teso
aferrado	insistente
carneiro	ossuário
rigidez	severidade
delapidar	entornar
palmar	roubar
absolver	escusar
bengalada	sarrafada
aquecer	indignar
conglobar	reunir
quitar-se	separar-se
imprimir	tipografar
encoimar	increpar
estufa	fogão
argentado	prateado
arremessar	propelir
abrilhantado	adereçado
chalacear	vasconcear
pleito	sabatina
açucarar	dulcificar
calmante	sedativo
bafejar	encorajar
seqüência	transcorrência
efeituar-se	realizar-se
abatimento	quebrantamento
entoar	soar
acovar	cravar
abranger-se	incluir-se
característica	particularidade
coluna	pilar
miserável	sovina
anunciar	expedir
alcagüetar	dedo-durar
solução	terminação
arreliar	encalmar
aspergido	borrifado
desvergonha	impudência
enunciar	mencionar
açouteira	rebenque
petrechar-se	premunir-se
desligar-se	separar-se
ludibriar	pantomimar
balanquear	pespontar
fúlgido	resplendoroso
patifaria	velhacaria
enchoiriçar	flagelar
esfazer	gastar
ferretoar	increpar
atontear	azamboar
acairelar	cairelar
desmemoriamento	esquecimento
cachar	capear
enegrecido	manchado
lixento	porco
afadigado	afanado
emotividade	sensibilidade
beneficiar	restabelecer
garrulante	palavreador
deslustrar	embaciar
chamejar	esplendecer
colorizar	decorar
germinar	levantar
certeza	segureza
aprontar	vencer
espremer	estringir
cachorrada	cainça
morder	zavar
legisperito	legista
reportar-se	temperar-se
novato	novo
encrespar	espetar
enfreamento	frenamento
importunar	molestar
exterminar	mandar
atroz	lacerante
favorecer	sorrir
criar	fornecer
regougar	rosnar
sacudida	tremor
erro	falha
insignificante	inútil
limpar	rastelar
enfrear	modicar
recondicionar	reparar
diligenciar	intentar
antagônico	contraditório
embate	oposição
afazer	avezar
desflorado	esflorado
imperfeição	senão
gralhar	palavrear
empurpurar	vermelhecer
barrete	casquete
depauperado	empobrecido
maligno	nóxio
cópia	traslado
adjudicar	concatenar
corrigir	ordenar
desfazer	rescindir
pegadiço	tenaz
açodamento	alvoroto
abominoso	aborrecido
engolir	rebater
abugalhar-se	arregalar-se
âmago	bojo
contra-arrestar	empacar
achatadura	amolgadura
sucedimento	sucesso
burlequear	haraganar
aquebrantar	infringir
amorenado	bronzeado
assombrear	entrevar
contrariar	desgostar
concordar	tratar
desmentir	diferir
manha	savoir-faire
gulodice	lambiscaria
calhorda	desprezível
relembrar	revivescer
pantear	zombar
mariposar	mariposear
discorrer	especular
intensificar	recrescer
avançar	vingar
curar	ocupar-se
estudar	habilitar-se
porte	vivenda
enfuriar	exaltar
declinar	sair
desmaecer	esmaiar
abespinhável	anojadiço
gretar	rachar
estradear	mandar
esfriamento	resfriamento
dizedor	tagarela
incólume	intacto
desocupar	vaziar
escárnio	ludíbrio
provimento	tento
devolutivo	devolutório
embuçalar	trautear
baratar	desvalorizar
nugativo	vão
socalcar	suplantar
ressaído	ressaltado
denegrecer	deslustrar
arredado	derivado
jovem	mancebo
acessível	comunicativo
abanar	balouçar
ameigar	ceder
regularidade	uniformidade
aromático	olorante
importuno	inadequado
desprestígio	queda
marroada	porretada
atafulhado	espadongado
amenoso	suave
equânimo	justo
impregnar	induzir
coruscação	relâmpago
deixar	respeitar
desmemoriado	esquecido
derreigar	desraigar
chavasqueiro	rústico
finalidade	papel
coligir	extrair
ressoar	rimbombar
esbarrar	refugar
individuar	privilegiar
cerebral	mental
captar	produzir
ciumoso	invejoso
marginal	ripícola
cândido	melindroso
suspensão	transporte
derrapar	patinar
gadelhudo	guedelhudo
rebentar	vir
abacelar	embacelar
desfiar	esgarçar
argüir	porfiar
emperrar	estomagar
apodrecido	decomposto
aclimado	avezado
alijar	cuspir
amodorrar-se	imergir-se
incoerência	incongruidade
apunhalar	frechar
aberto	aprofundado
melhorar	serenar
harpagão	sovina
enzonzar	estontear
circular	mexer-se
desamável	grosseiro
degelar	desgelar
escabritar-se	estomagar-se
berregar	expluir
obcecação	paixão
apalermado	tolo
antidemocrata	antidemocrático
extravaganciar	malbaratar
agitado	fremente
fortificação	praça
emporcalhar-se	enodoar-se
augurar	conjecturar
bamboleante	gingante
afluir	refluir
aprestado	preste
alhanado	igualado
abrangência	encerramento
alborcar	cambar
dar	engendrar
descreditar	exautorar
babaca	babão
defumar	perfumar
estafa	exaustão
roldão	sarrabulhada
atiçar	espicaçar
concutir	encasquetar
altaragem	voto
aparelho	utensílio
arcaboiçar	esboçar
assinar	traçar
estuporar	perder
câmbio	troca
colorante	corante
matagal	selva
negociado	permutado
dúlcido	fagueiro
desasseado	espurco
dessoterrar	revelar
embasbacado	surpreso
devaneio	faz-de-conta
corromper	malignar
barulhoso	rumoroso
comprobação	confirmação
contaminar	infeccionar
poder	suportar
inçar	invadir
atingir	fisgar
apoquentar-se	molestar-se
deliberado	resoluto
exsuar	transudar
depreciação	maledicência
complicação	embaraço
desterro	solidão
alagado	arrasado
arruaceiro	bagunceiro
adensar	condensar
pername	pernão
cansaço	lassitude
agregar-se	consociar-se
fiel	sectário
exploração	parasitismo
dilapidar	esfrangalhar
encabular	perseguir
zabumbar	zupar
queimar	requeimar
calafriento	calefriento
atumultuar	desarrumar
belo	suave
aromalizar	balsamar
abeirante	rente
puxar	tender
estabilidade	firmeza
objetivo	objeto
andar	operar
arrebatado	desembestado
aprazado	procrastinado
anojar	entediar
caborje	salgação
distinguido	divisado
bimar	bímare
brejo	sapal
incendiar-se	referver-se
patetear	pejar-se
hipócrita	refalsado
lentescente	pegajento
nuvem	sombra
descombinar	inimistar
batalhar	militar
cusparada	cuspinhada
impersistente	inconstante
denotar	expressar
arrependido	compungido
assustador	terrível
arenguear	rezingar
conta-giros	taquímetro
desgrenhar	enredar
abrigado	amparado
estendal	varal
rebrilhante	resplandente
espinicado	janota
costume	uso
persistir	ter-se
facetar	refinar
encoberto	nuvioso
farfante	vaniloqüente
espinho	ferrão
arrelia	zanga
espetar	traspassar
adocicado	melífluo
comparável	parecente
desatender	empalidecer
gebo	mal-apresentado
fé	religiosidade
esplendecer	flamejar
borbotão	borbulhão
descarregar	desquitar
remover	transferir
anteferir	preferir
genetriz	genitora
deter-se	plantar-se
fornir	munir
alterar	danar
impedimento	obstáculo
contestar	contrariar
engraxador	engraxate
cabeçudo	contumaz
hierático	religioso
empreendimento	firma
guarda-louça	louceira
coriscar	relampear
fulgor	rutilação
glutinoso	peguenhento
anojadiço	azougado
alentoso	alto
desgarrar	empestear
instantâneo	momentâneo
encruar-se	excitar-se
desempachar	livrar
maçador	paulificante
esperteza	subtilidade
repetir	voltar
estuoso	febricitante
entufar	inturgescer
fementido	frustratório
rumor	runrum
proteger-se	velar-se
desvirtuar-se	perder-se
alcantilado	alcantiloso
acalentar	bafejar
elanguescer	prostrar
bacante	tíade
pacato	tranqüilo
gabela	gavela
atender	ver
graduação	graduamento
alcançar	depreender
transgredir	travessar
apedrar	lapidar
fuzilar	luziluzir
ardejar	chamear
fragrante	odorífico
lisonjear-se	repastar-se
desobstrução	desobstruência
comido	nutrido
semi-aberto	semicerrado
cuidadoso	cuidoso
inibir	negar
consecutivamente	sucessivamente
desumano	subumano
embuste	embustice
ranger	rechinar
aumentar-se	intensificar-se
afanar	ladroar
intermear	intermediar
esmerilhar	limar
abolorentar	mofar
bestial	desalmado
divagar	flanar
embriaguez	inebriamento
acabrunhado	aniquilado
espalhar	juncar
aceso	arremessado
correr	enxotar
abracadabrante	mágico
glorificar-se	jactar-se
arrogância	inchação
garrir	papear
horda	tropel
bolar	engenhar
registar	titular
irritadiço	violento
moiro	mourisco
cariciar	cortejar
parasitação	parasitismo
rasar	rasoirar
folgador	galhofento
inopinado	subitâneo
acurado	aprimorado
crescido	fermentado
apancado	estólido
corrompido	corruptivo
encarquilhado	esmarrido
liberdade	permissão
acotovelar	esporar
aporfiar	questionar
asserenar	calmar-se
atopetar	lotar
desadormentar	despertar
desfeita	inconsideração
empapar	engrampar
lameiroso	lutulento
grande	profundo
administrar	governar
infesto	ruinoso
humilhante	vexante
bradar	esgoelar
congestionar	entupir
espalhafato	vozearia
cobrir	satisfazer
desmiuçar	estriçar
lasca	talisca
encabrestar	submeter
ressequido	torrado
baldrocar	tapear
envaidecer-se	intumescer-se
improvidente	negligente
agrestia	rudeza
cru	feroz
anegrado	negrusco
coligar-se	ligar-se
engrolado	tapeado
apeçonhentado	peçonhento
antipático	contrário
pautar	recensear
decretar	impor
conturbar	desacomodar
açodar	apicaçar
enleio	envolvimento
azedia	pique
balneário	terma
dormideira	modorra
enfarar-se	enjoar-se
duvidoso	irresoluto
aforismal	aforístico
facultoso	opulento
alambazado	lambaz
errabundo	vagamundo
quietude	suavidade
donaire	ornato
adstringir-se	restringir-se
intricar	intrincar
agastamento	arrelia
perseverar	persistir
arrear	vestir
desperdiçado	extravagante
abobalhado	apatetado
horroroso	tétrico
desencarrilhar	desmandar-se
desfortalecer	desvigorar
entrecruzar-se	travar-se
abiúdo	adiantado
desvalidar	revogar
sibilar	tinir
cachaçudo	soberbo
caído	gelado
aiar	ulular
abespinhado	sanhoso
depender	originar-se
consternado	desolado
afilado	apuado
claro	morto
achambonado	achavascado
reger	regular
brejoso	charqueiro
rinha	rixa
acabado	encerrado
benquistar	compor
acender	espicaçar
abrilhantar	avivar
organização	sociedade
exagitar	marfar
excepcionalmente	extraordinariamente
desarborizar	desmoutar
retransir	transpassar
apandilhar-se	deslustrar-se
clava	toco
banana	pateta
desafortunado	infortunado
atropelar	enlabirintar
capacidade	competência
centelhar	vagalumear
restabelecimento	restauro
interpretar	ter
desabrido	desamorável
definito	preciso
aprazível	sonoro
amenta	voz
selvagem	silvícola
artimanha	raposice
endurecimento	pertinácia
milenar	milenário
embonecrar	pendoar
modelo	tipo
espiráculo	resfolegadoiro
emascarar	sufocar
adinamizar	desvigorizar
empeçonhar	prevaricar
argúcia	transcendência
contundido	pisado
cerrado	unido
amical	amistoso
galear	janotar
embrulhar	ludibriar
acariciador	amimador
aparatar	ornamentar
engrampar	enloisar
comunhão	união
exercitar	trenar
pugnador	pugnaz
envinagrar-se	reprurir-se
abilolado	desabotinado
hástea	vergôntea
aguilhoar	inflamar
fanado	torrado
assustar-se	espaventar-se
reabastecimento	refornecimento
decisão	determinação
abarregar-se	juntar-se
desajeitar-se	perturbar-se
discernir	medir
azul-do-céu	cérulo
individualmente	singularmente
apocalíptico	intrincado
dificultar	fechar
afanoso	fatigante
pregar	tracionar
delgado	delicado
desacorçoado	desencorajado
licencioso	obsceno
barracar	enrinconar
desalinhar	desaparelhar
embuchar-se	locupletar-se
sacerdote	tonsurado
fundar-se	jogar
abandonar	negar
desgovernado	estragador
atabalhoamento	pipoco
afastamento	apartada
penitência	tortura
açaimar	medir
desengatilhar	transfazer
injúria	opróbrio
foguear	ruborizar
estuporar-se	imobilizar-se
abaixar	acocorar
conubial	marital
chateza	estopada
lesto	presto
embatumar	preencher
safar	sobnegar
consistente	pastoso
chilreiro	dizedor
desmobilhado	desmobiliado
alar	guindar
emproar-se	entufar-se
enlaçar	estreitar
encanudado	encanutado
desesperante	desesperativo
redutivo	redutor
enlear-se	enredear-se
debulhado	escorchado
embalador	ilusivo
vaivém	volta
alvear	dealvar
sobreabundar	superabundar
deaurar	doirar
friento	friorento
atrativo	poesia
aborrido	maçante
pardieiro	tapera
flutuador	salva-vidas
fraudar	tolher
corrugar-se	encorrilhar-se
excedente	sobra
desambicioso	desapegado
deleitar-se	satisfazer-se
estroinar	patuscar
albergaria	poisada
conchavo	mancomunagem
penhorar	seqüestrar
investir	lançar-se
aparamentar	colorizar
eletrizar	esporar
abracável	abrangível
pitônico	vatídico
empavonar-se	estadear-se
empavonear-se	envaidecer-se
berrante	clamador
dilapidador	prodigalizador
cachamorrada	marretada
latir	vociferar
estimular	impelir
verdejante	verdoso
languescer	prostrar
arrepiar-se	enchoiriçar-se
adomar	temperar
difícil	fatigoso
vário	volátil
categoricamente	expressamente
infecionar	pestiferar
esperdiçar	prodigalizar
intriga	invenção
cegar	embaciar
cisão	corte
abananado	apombocado
assentamento	firmação
descantar	entoar
jactante	loroteiro
concluir	deduzir
devassar	esmiuçar
abestalhado	atroado
consumir	dissipar
bestar	vagar
abalroada	colisão
admissão	aprovação
debandar	estroçar
abreviado	encondensado
sovinice	tacanhice
desacreditar-se	difamar-se
sinopse	súmula
escandescer	pruir
ativo	laborioso
paniguado	protegido
fincar	meter
fortificar-se	oxigenar-se
anúncio	vaticínio
alfobre	alfofre
drogomano	turgimão
falatório	rumor
aleijar	jarretar
cômodo	tranqüilo
afetar	irritar
esgoelamento	gritadeira
adamado	alfeninado
atiramento	remetida
desprezável	reles
examinar	perscrutar
desconcertar	desestruturar
horripilante	temerso
restrugir	zonzear
teste	verificação
envencilhado	implexo
desfalcar	diminuir
arrombamento	depredação
poetificar	versar
estarrecer	fulminar
desgovernar	viciar
agastado	enraivecido
chavascada	preacada
atormentar	chicotar
fúsil	fusível
desmembramento	destroncamento
amolgar	prostrar
certâmen	justa
aformosentar	ajaezar
apejar-se	oscilar
aflitivo	dilacerante
caixa-forte	cofre-forte
cineração	incineração
ignavo	manzanza
aperrar	insistir
idiotismo	zotismo
burricada	parvoíce
dissolvência	liqüidificação
arrear-se	fanfarronar
fúnebre	funeral
homogeneizar	uniformizar
sapateado	sapateio
evidenciar-se	patentizar-se
albergar	asilar
aniquilado	apeado
desembutir	desmontar
amarasmeado	letárgico
entrever-se	vislumbrar
limitado	restringido
dissimulado	indireto
contrastar	opor
aberta	abertão
governar	tronejar
alarmar	ariscar
afouteza	coragem
apaixonante	sedutor
mantimento	retenção
rabeira	viso
chutar	enjeitar
agarrar	garrear
aloucar	variar
acroase	dissertação
intertecer	obrar
estreitar	minuir
inclinar	pender
mundificar	purgar
imperecedor	perene
nitente	resplendente
enfurecer	exasperar
atristar	ofender
abluente	detergente
desabrigo	desagasalho
agigantear	agravar
arrematar	inteirar
iracundo	zangado
abelhudo	metido
afrouxar-se	entorpecer
abobadado	recurvado
aprofundar	desencovar
aflar	inspirar
charlar	tartarear
absorver-se	empregar-se
desaparecer	meter-se
faina	lide
determinado	feito
desalforjar	infundir
adulterado	contrafeito
desapertar-se	soltar-se
adulterar	extraviar
choroso	sentido
destilar	transcoar
concitar	reprurir
retirar-se	vazar
desidratar	ressecar
lamaceira	lameiro
assanhado	sanhoso
masticatório	mastigatório
escorregar	falhar
forte	musculoso
compilar	reunir
banzar	remoer
cascar	descorticar
brilhante	fastoso
louco	tresloucado
avizinhar-se	conchegar-se
comunidade	irmandade
apaziguamento	harmonia
compadresco	compadrio
desfruir	gostar
esperado	provável
balroar	preliar
desmanchar	esfacelar
abalroar	contender
encapar	entroixar
comunicativo	expansivo
bravatear	fumacear
cansar	entibiar
deleite	prazimento
abonecar-se	ajaezar-se
afincado	tenaz
ecfrático	picante
barrufar	pingar
quieteza	tranqüilidade
fortificar	vitalizar
ofuscamento	turvamento
arqueado	combo
amaneirado	apavonado
destrinçar	particularizar
aleijado	mutilado
esterroado	estorrado
desenredar	desvincilhar
lumeeira	lustre
felicitar-se	gratular
gambelar	tungar
meter	sepultar
lamuriante	lamuriento
beliscar	estugar
desembaraçado	expedito
anular-se	desgregar-se
loquaz	multíloquo
espaço	trecho
derivar	jorrar
agregado	ajuntado
eumatia	subtilidade
porfiar	renitir
abatido	rebaixado
amedrontar	intimidar
bispar	surrupiar
marca	vestígio
distinto	esclarecido
trotar	vasconcear
cavador	furador
tábua	tela
aviltamento	vileza
crônico	enraizado
pimpar	pimponear
proferimento	pronunciação
facetear	motejar
escarrapachado	esgarranchado
brilhar	sobressair
abrutalhar	bestializar
acirrar	pruir
esgrimir	litigiar
blague	sal
imposição	obrigação
desvaecer	ensoberbecer
caber	conter
palonço	tolo
colubrejar	serpear
depravar-se	enchafurdar
espantoso	horrífero
fugido	tresmalhado
comutar	escambar
doidejar	flanar
circunspeção	prudência
amuar	repanhar
arrebatar	palmear
estafar	fadigar
colaboração	conspiração
empegar-se	mergulhar-se
reformar	restabelecer
embarrar-se	entujucar-se
azar	desfortuna
medidor	relógio
adoçar	aligeirar
açoute	flagelo
conter	reportar
ajeitamento	conchavo
querençoso	simpático
desarraigamento	extirpação
boboca	paspalhão
transir	trespassar
aprimorar	facetar
amortecido	mortiço
desbrecar	desfrear
chatinar	subornar
desentulhar	livrar
prova	testemunho
arraigar	implantar
alombado	curvo
embaraçado	torvado
abstemia	frugalidade
amaldiçoar	anatematizar
precautelar-se	precaver-se
endoidecer-se	perturbar-se
audacioso	longânime
acomunar-se	mancomunar-se
desmiolado	esmiolado
enviperar-se	exceder-se
ingênuo	puro
derrear	desprezar
gosto	paladar
esfarelar	esfarinhar
guardar	poupar
aplauso	aprovação
encarquilhar	surcar
avergoado	maltratado
batido	calcado
ferro-velho	sucata
exsolver	liqüidar
atordoado	atrapalhado
escarnecer	pagodear
desponta	surgimento
catraca	roleta
embriagamento	embriaguez
amoitar-se	entrouxar-se
erubescer	rosar
adjunção	associação
falar	impor
coçar	surrar
grota	vale
avultar	desremediar
clitorídeo	clitoridiano
padroeiro	protetor
desirmanado	diferente
efundir-se	espalhar-se
escupidor	estatuário
agermanar-se	envolver-se
blasonar	parlapatear
acatamento	obediência
depositar	enceleirar
baixo	convidoso
adiável	protelável
entrada	porta
rematado	ultimado
embravecido	furibundo
carnificina	matança
gorjear	trinar
lorpa	palúrdio
igualar-se	nivelar-se
emporcar	inquinar
trôpego	zopeiro
desunião	dissensão
inflamar	soprar
endemoninhar-se	envinagrar-se
azucrinado	incomodado
continente	parcimonioso
cintilante	fulguroso
crer	pressupor
cantar	levantar
condessar	meter
empaçocar	machucar
enovelar-se	enrolar-se
encapeladura	encrespamento
gelar	regelar
concionar	discursar
lamelar	laminar
cientificar	comunicar
capear	carambolar
esfrega	ralhação
meretriciar-se	prostituir-se
entabuar	solhar
coberta	ensombro
caráter	qualidade
ambulativo	errático
arrefentar	torpecer
desferir	encavilhar
antropóide	homínido
interessar	pertencer
peralvilhice	tafulice
gordalhufo	gordão
atadura	prisão
eônico	eônio
empinar	virar
enxadrezar	escaquear
sobrevivo	supérstite
refrear	represar
janotar	janotear
furacão	torvelim
badanal	balbúrdia
lengalenga	litania
almofadado	estofado
estender-se	prolongar-se
penetrar	pescar
defender	vetar
fenomenal	portentoso
brandura	macieza
anemiado	enfraquecido
avergar-se	tornejar-se
murmurar	rezingar
enuviar	sombrejar
desajudado	desamparado
abranger	possuir
embuziar	enlambuzar
desapertar	libertar
prever	surpresar
afunilar	estreitar
analisar	farejar
desmoutar	humanizar
lacaio	volante
descomedido	desenfreado
excluído	suprimido
afamado	egrégio
chasquear	pantear
deslindamento	destrinça
detector	radar
antecessor	antepassado
abalofado	arrebicado
ostentação	vaidade
escurentar	turvar-se
destratar	ultrajar
agudeza	fineza
afamilhar-se	juntar-se
adelgar	empalecer
cancelar	rescindir
alegrar	animar
aborrecimento	chateação
encaminhado	guiado
desígnio	sorte
antedizer	pressentir
corruto	vicioso
engrossar	espessar
característico	genuíno
bacharelice	culteranismo
circundar	perlongar
baba-ovo	lambe-botas
avariar	estrompar
despiolhar	esquadrinhar
amovível	removível
pejamento	vexame
abafador	abafante
gatuno	ratoneiro
esmadrigar	perder-se
recortado	rendilhado
agente	propulsor
aumentar	avantajar
horrípilo	horroroso
desinquietar	tentar
crepitar	estralar
abastecer-se	açalmar-se
cruciar	remoer
inquieto	traquina
desvio	divagação
imundo	obsceno
obtemperar	submeter-se
desflorir-se	findar
acumetria	acuometria
odorífero	perfumado
marinheiro	marítimo
reconhecer	retribuir
alienado	endoidecido
abelhudar	sondar
desapear	destruir
lamentoso	magoado
oblíquo	transversal
limite	linda
deslumbroso	triunfante
desancar	malhar
afligente	cruciário
acabrunhar-se	atormentar-se
adregar	vir
atilamento	precaução
teima	teimosia
detruncar	tronchar
apor	incorporar
bonança	sossego
abrutalhado	rude
colorir	encangotar
desertar	sair
defraudar	gatunhar
preservar	salvar
neblinar	pingar
auditor	ouvidor
inficionar	malignar
professar	ter
rebentação	romper
ralo	ronqueira
articulação	união
avançamento	avanço
sobreeminência	supereminênica
ocultar	sonegar
obrigar	superar
asseado	delicado
desconjuntar-se	inutilizar-se
simplesmente	unicamente
branco	lácteo
clemência	indulgência
marasmado	marasmático
bestificado	estupefeito
desacreditar	detratar
desaproveitar	economizar
inteiro	salvo
floretear	sobredourar
arremenicar	retorquir
abrasear	enrubescer
cinéreo	cinzado
tentador	tentante
lentescer	regar
impuro	incontaminado
apreciar	examinar
empachar	fechar
afalcoar	estimular
diferente	variegado
machucho	velhaco
arder	piançar
enfestar	estopar
fel	travo
bandurrear	bestar
esbracejar	espernear
arregaço	esfrega
digno	direito
íntimo	pessoal
excessividade	superfluidade
anipnia	insonolência
precipitar-se	projetar-se
enxameação	enxameamento
contorção	torço
pélago	precipício
frígido	glacial
primordial	substancial
longo	prolixo
lenificar	lenir
metamorfosear-se	mudar-se
debochador	zombador
rejeitar	revessar
amolado	saturado
amelindrar	mazelar
deslizar	rabear
arruinar	avariar
decorar	honestar
deslumbrante	fastuoso
marcha	processo
engastar	interserir
pimpolhar	proliferar
agigantar	ampliar
corredio	macio
efusão	emborque
adulterino	contrafeito
aliviar-se	mitigar-se
coarcto	coarto
incensador	louvaminho
formidando	horrípilo
criterioso	ponderado
atroçoar	migalhar
caramboleiro	cuvilheiro
ardil	traça
latejo	pulo
sinistramente	tragicamente
crespo	encapelado
trapalhada	trapalhão
acudir	afluir
engelhado	rugoso
aformosentamento	ataviamento
sobrepor	superpor
responder	revidar
goguento	gosmoso
abajoujado	hebetizado
amotinar	atumultar
indeciso	indeliberado
previsão	prognóstico
intermediário	terceiro
demente	louco
biliar	bilioso
passar	romper
afastado	retirado
acoimar	encoimar
emaciado	emagrecido
lameirão	lodaçal
desenferrujado	desentorpecido
confutar	impugnar
azedume	pesadume
empurpurecer	vermelhar
afroixar	bambar
metonímia	transnominação
pompear	pracear
acinte	injúria
austeridade	rudeza
acapachado	humilhado
fortalecer	oxigenar
bochincheiro	rusguento
teada	textura
desafiar	peguinhar
transiente	transitivo
cabana	tijupar
angustiar	mortificar
abater	desapear
denudado	desnu
arfar	jogar
emergir	mostrar-se
haver	ter
esfalecer	esmorecer
tempestear	toar
espedaçado	estroçado
caridoso	caritativo
cineral	cinzeiro
confutação	objeção
aclarecer	escurentar
atrancamento	atravancamento
aborrecido	maçador
atrevimento	protérvia
circunstanciar	pormenorizar
lúcido	nítido
adereço	requifife
contrapontear	repostar
coadunar-se	congregar-se
incivilidade	rusticidade
preferir	prepor
sofreado	sufocado
franquear	palrar
ajoeirar	sengar
lascívia	luxúria
checar	reverificar
aninar	ninar
curto	rápido
desempenhar	praticar
acostumar	traquejar
absconso	esconso
esfarelamento	esmigalhadura
amargurado	mortificado
gambérria	sancadilha
confiar	encargar
cognado	cognato
coação	pressão
dobrar	pressionar
récipe	ripada
bazofiar	galrar
retorqüir	volver
indicar	ter
carismático	epiléptico
barrar	engarrafar
esfoladela	esfoladura
absolver-se	isentar-se
competente	gabaritado
jogar	projetar
estiolar-se	queimar
lisonjear	satisfazer
experiência	prática
folgar	soltar
intensidade	veemência
avaro	sovina
acolher	agasalhar
abscôndito	oculto
desassossego	inquietação
apanhar	apropriar-se
bocó	zote
extenuar	languescer
descansar	poisar
burlesco	cômico
abobado	abobarrado
encanastrar	entrelaçar
vigiar-se	vigilar-se
afadigar	pregar
alevantar-se	pronunciar-se
orifício	vão
escalavrar	estrompar
encasar	inculcar
disfarçar	solapar
rombo	rompimento
parasitar	sugar
alimentar	conservar
aboiar	bubuiar
carinhosamente	meigamente
cismático	cogitabundo
mungir	ordenhar
topada	trombada
fatigante	paulificante
chegar	vingar
gargantão	glutão
desengrandecer	desvirtuar
otário	trouxa
fecúndia	riqueza
batida	rebordosa
esborniar	frangalhotear
andrômina	artifício
recuperar	renovar
explicar-se	ilustrar-se
drenar	extrair
bem-proporcionado	esbelto
molesto	secador
assecla	partidário
afetivo	namorado
chicote	relho
aconchegar	vizinhar
ângulo	ponta
chasqueador	ludibrioso
froixo	relaxado
aiaia	brinquedo
bafejo	brisa
coalhar	solidar
aloirar	enloirecer
cuspidor	escarradeira
desanojar-se	desenfastiar-se
árido	fastiento
decantar	refinar
caçoante	zombador
encrespação	enfurecimento
concretizar	efeituar
abaré	padre
esplandecer	fulminar
comover	desencruar
ajeitar	congraçar
falange	multidão
instintivo	natural
assanhar	derrancar
intencional	premeditado
corrugar	encoscorar
dúctil	flexível
adjacente	arredor
repousado	sopitado
alambicado	enfatuado
liame	nó
estraçalhar	estraçoar
assovelado	provocado
floreado	flóreo
desgastado	surrado
derramar	partir
indefendível	indefensável
burla	fraudulência
degradar	desonrar
pleonástico	redundante
gordaço	gordalhufo
direito	sério
insurrecionar-se	sublevar-se
alarve	grosseiro
lôbrego	tétrico
chilrear	estribilhar
falta	imperfeição
devotamente	religiosamente
crena	fissura
ancho	enfatuado
corretora	terceira
desamparo	solidão
despojo	presa
mesclar-se	promiscuir-se
querela	quizília
obedecer	trilhar
assassinar	destruir
despojar	orfanar
efeito	êxito
experto	mestre
idêntico	parecente
abrupto	ladeirento
surpresar	vislumbrar
contrapor	voltar
cumular	encastelar
postulado	rogado
endurecer	revitalizar
flagelo	zorrague
lusíada	lusitano
chibatada	verdascada
agro	decepção
particularmente	privadamente
engabelar	impingir
memorável	memorial
abrandar	desempedernecer
deslocar	desnocar
amota	marachão
acenar	menear
desarmonizar	dissentir
aviamento	preparativo
arrematação	rematação
chiar	ferretoar
nebrina	nevoeiro
bem-criado	fino
sobrevivente	supervivente
exulcerar	ulcerar
alimentação	estimulação
amolestar	vulnerar
autenticar	validar
cornadura	haste
reconstituir	reparar
oxigenar	vigorar
desenhar	esplender
poeirento	polvoroso
generoso	ubertoso
empedrenir	endurar
salpicado	sarapintado
focalizar	marchetar
escorchar	sobnegar
basear-se	estear-se
cravado	fixo
decorrência	decurso
acarminar	envermelhecer
emparelhamento	nivelamento
destoucar	enfear
matulagem	sarandagem
espículo	pua
esquentar	irar
encruentar-se	incitar-se
exaustão	sobernal
confim	fronteiro
acima	ascensionalmente
galgar	vingar
enfeitado	paramentado
generalizar	preconizar
rir	vasconcear
calado	embuchado
tríada	trio
acochar	inquerir
chispar	indignar-se
mazorro	napeiro
aparvoado	mazanza
tramolhada	tujuco
desacordo	discrepância
calmar-se	desencalmar-se
emanar	transverberar
fugir	zarpar
cobardia	covardia
cortar	obstruir
derrubamento	prostração
entaleigar	preencher
desautorizar	negar
afastar-se	alhear-se
encruecer	insensibilizar
imprevisto	súbito
comportável	conciliável
congênere	parecido
escumante	espumígero
emplasmado	valetudinário
abordada	abordagem
carnear	siderar
nervoso	nevrino
pragmática	protocolo
achatar	esmagar
bojamento	bojo
anulação	inutilização
emborrascar	revoltar
intumescente	tumefato
alcatruz	caçamba
desflorestar	desmoutar
gênio	temperamento
melindroso	puro
denudar	despir
emoldurar	revestir
achatar-se	agachar-se
baldaquino	sobrecéu
bilontragem	vergalhada
gaguejar	tartamudear
provir	vir
estrilar	estrondear
adorno	guarnecimento
encarcerar-se	enterrar-se
ajudar	servir
tosquiar	trosquiar
estilar	gotejar
ímã	magnete
descrédito	queda
luxo	riqueza
boldrié	talim
azul	ébrio
briguento	rusguento
esperdiçante	gastador
dealvar	lavar
alusivo	concernente
galonar	louvar
amoedado	opulento
mindinho	mínimo
alcunhar	sobrenomear
trajado	vestido
alardear	pracear
penalizar	pungir
discurso	predicação
comprimir-se	contorcer-se
agourar	saber
associação	congregação
opressão	violência
patranha	tretas
grossaria	grossura
amoestar	censurar
batalha	torneio
apaziguar	tranqüilizar
arrufar-se	enchoiriçar-se
alienar-se	enlouquecer-se
estoiro	trovão
flamífero	flamígero
apepinar	tourear
parvajola	zângano
endurentar	esticar
designado	nomeado
antepor	preferir
alheado	desassisado
engrinaldar	recompensar
estupidez	parvoíce
aceitação	aprovação
desgostoso	dissaboroso
esboroar	esbroar
congênito	nativo
rodamoinho	tragadoiro
insolente	petulante
inscrição	lançamento
pingotear	transcoar
adivinhar	depreender
deludir	tapear
afutricar	fuxicar
afigurar-se	recordar
sirtes	transe
infrutuoso	ocioso
sorrelfa	sovina
conveniente	pertinente
estrangeiro	forasteiro
abordar	versar
abusado	intruso
carão	tosa
dessossego	fogo
devasso	imorigerado
codilhar	embaçar
limitar	reduzir
bailarim	dançarino
aproveitamento	préstimo
degeneração	podridão
estrondoso	sumptuoso
desconhecer	subestimar
amente	delirante
refocilar-se	vadiar
gasto	safado
alambicar	madurar
capacitado	capaz
burlaria	falsificação
dessaborido	dissaborado
enlevar	envolver
escarcéu	grita
assetar	detrair
cacarejar	chilrar
emborralhar	enlodar
arvoamento	desorientação
predito	prognosticado
enfim	finalmente
alabarar	foguear
ensombro	toldo
guiar	levar
evadir	zarpar
derrogar	revogar
instigar	levar
mostrar-se	repontar
furdunçar	pagodear
compungido	pesaroso
molestado	ofendido
difamado	enodoado
cauíla	tacanho
ferramenta	utensílio
absoluto	tirano
inativo	sedentário
empedernir	endurecer
estrabar	laxar
enxugo	varal
ardiloso	sonso
generalidade	universalidade
amarroado	pensativo
sentir	travessar
cúpido	sequioso
detalhar	maquinar
impolidez	malcriadez
aplastar	esbofar
soalhar	veicular
deformidade	perversão
afigurar	traçar
estímulo	sugestão
espipocar	estralar
cadimo	sagaz
desvalijar	sonegar
carniceiro	magarefe
malhar	vasconcear
encolher	intimidar
escabichar	esmerilhar
apurar	procurar
nota	observação
manter-se	nutrir-se
álbido	alvacento
extremar	reduzir
arrijar	inteiriçar
radical	radicalista
rememorar	ver
nítido	resplandecente
afamar-se	resplender
capanga	pistoleiro
longânimo	magnânimo
conatural	nato
barcada	barcagem
enregelar-se	gelar-se
espigado	graúdo
enxuto	seco
avoado	confundido
imbecil	parvo
desemburricar	morigerar
incender-se	incendiar-se
milagroso	tremendo
raspado	sumido
amabilidade	meiguice
alveiro	entrebranco
impureza	sujidade
flutuar	patetear
debicar	sotaquear
quéchua	quíchua
muscoso	musgoso
alumiar	clarear
encondensado	substanciado
contemporizar	repoisar
cominuir	moer
firma	rubrica
animador	confortador
afofado	regateiro
manino	pequenino
cacunda	canastra
panorama	perspetiva
duvidosamente	hesitantemente
desnortear	entontecer
altivamente	arrogantemente
encarvoado	encarvoejado
relevar-se	sobrelevar-se
assar	queimar
flente	lacrimante
atração	desejo
achinfrinado	turbulento
contratar	firmar
altaneiro	cachaceiro
falcado	falcular
crendeiro	simplório
acautelado	velhaco
esquipático	extravagante
corretor	intercessor
distraimento	prazer
edulcorar	placar
desalento	desanimação
bêbado	mordido
aninhar-se	encafurnar-se
rapinador	rapinante
birote	pericote
idealizar	sonhar
aporreado	espancado
desvaecer-se	extinguir-se
molestar-se	quizilar-se
jubiloso	jucundo
apresto	avio
corporatura	vulto
aflado	assoprado
beijar	oscular
gabar-se	timbrar
eclipsar-se	socar-se
apalavrado	concertado
assegurar-se	fundar-se
debruçar-se	enconchar-se
escarapelar	escarpelar
asinário	manco
delusório	quimérico
contentar	repousar
alicantinador	alicantineiro
sumamente	sumariamente
partir-se	remoer-se
altanado	alterado
apontado	sugerido
transubstanciar	transvestir
abreviativo	simplificador
sarçal	silvado
concurso	cooperação
enrodilhar	trautear
desprecavido	imprevidente
corrupção	depravação
desfazer-se	estilhaçar-se
desunir-se	esfazer-se
triunfante	vencedor
britar	migar
grau	predicamento
estabelecimento	instauração
singelo	virginal
torcedura	torcilhão
apregoar	disseminar
epitomar	recapitular
bagaço	engaço
calcitrar	engravitar-se
estilhaçar	estilhar
acanhamento	aperto
acasalar-se	concubinar-se
progenitura	sóbole
gases	vento
dobramento	vinco
amargor	amargura
desobrigar	exonerar
aperaltar	janotear
inação	irresolução
flébil	triste
acre	agro
importância	respeito
desalagar	desencalhar
precatar-se	precautelar-se
desclassificar	quartejar
baixeza	labéu
censionário	censitário
homotermal	isotermo
derrubar	desmontar
mogangueiro	munganguento
pelintra	somítico
galreador	galrejador
ajarretar	truncar
cheiroso	olorado
amável	caroável
fascinador	sedutor
apoiar-se	escudar-se
lambão	paspalhão
desconsiderado	irrefletido
arrumar	expelir
pulgoso	pulguento
encervejar-se	encharcar-se
escuro	turvo
desenrolar	sucessão
arrojo	lançamento
exatamente	mesmo
puníceo	rubicundo
estafado	puído
alarvado	grosseiro
insistente	testudo
engendrar	ter
comprometer	compromissar
desfolegar	resfolegar
indisciplinado	rebelde
cabalar	enredear
bastão	denso
enegrecer	rebaixar
apaniguar	sorrir
descompor-se	desorganizar-se
domar	sopear
energia	valentia
cumprir	interessar
azeitoso	graxo
aragem	bafejo
formoso	preclaro
atrito	cisma
demão	retoque
criticável	culpável
carregar	prostrar
ponteado	pontoado
aventar	refrescar
pegar	unir-se
encorrugir	enrugar
bater	delombar
alumbrar-se	iluminar-se
flamejar	fulminar
lavor	trabalho
laborioso	molesto
desentalar	desvincilhar
alheio	inatento
delírio	desatino
afetar-se	prejudicar-se
adormentar	amortificar
confinar	determinar
declivado	escarpado
assombroso	estranho
nublar-se	turvejar-se
burlescamente	comicamente
peruar	requestar
jaldinino	jalne
compacto	maciço
mencionar	pronunciar
aguerrido	varonil
bexigar	trotear
minar	surdir
despundonorado	despundonoroso
entressachar	intervalar
infecionado	infectado
empilhamento	sobreposição
garguitear	ufanar-se
despedaçamento	dilaceração
embatucar	entrelaçar
arcabouçar	riscar
duplicador	duplicante
traquinagem	travessura
bacorejo	intuição
eventual	ocasional
desvairar	embebedar
acurvado	alombado
espaventar-se	sobressaltar-se
tunador	vagabundo
acercar-se	aconchegar-se
argumentar	renhir
encabeçar	sobreintender
ambilateral	bilateral
avassalamento	extermínio
cova	furna
profecia	vaticínio
abarreirar-se	resguardar-se
escumoso	espumígero
apurado	requintado
imaturo	prematuro
murcho	ressequido
destroço	dissipação
assanhar-se	encolerizar-se
desabituar	desacostumar
descerrar	respirar
desmerecer	rebaixar
pergurar-se	transfixar-se
aliciador	aliciante
encelar	trincafiar
forjado	maquinado
aborto	anomalia
diabrura	molecagem
deflexão	deslocamento
peleja	prélio
partimento	repartição
debochar	troçar
morrer	rematar
converter-se	imutar-se
emburricar	engabelar
caixa	caixote
traspasso	vagareza
abraço	ligação
afronta	ataque
colina	morro
garalhar	papaguear
especificador	especificativo
cacaria	caranguejola
ataviar-se	embonecar-se
afortalezar	oxigenar
caolho	zerê
escorrência	liqüidez
desacautelado	imprevidente
acumulação	aglomeração
desenleio	destrinça
acreditar	crer
irradiar	lançar
experimentar	tentar
confranger	morder
fedegoso	fedorento
assomada	pique
mudar-se	trocar-se
ralhação	ralho
catar	seletar
alumiamento	luzimento
encerrar-se	terminar-se
rodilhar	tapear
atalaia	vedeta
emprenhar	galar
acurtar	compactar
percentagem	porcentagem
abundar	sobreabundar
ignóbil	miserável
afamar	celebrizar
chorrilho	montão
dardejar	relampadear
extinguir	solver
aconchegado	aproximado
moderar	suavizar
lutar	questionar
prevaricação	salacidade
estábulo	estala
uniformar-se	uniformizar-se
asneira	babugeira
antevidência	previdência
descontrole	desgoverno
ostensível	visível
caco	entulho
luta	pendência
deslumbramento	fascínio
azuretar	desatremar
galantear	ornar
acabamento	destruição
bobo	patau
laconizar	substanciar
esbandulhado	esbarrigado
reinterrogar	reperguntar
conjeturar	esmar
alternação	diversificação
francófilo	galófilo
conclusivo	dedutivo
amancebado	cambondo
bem-sonante	sonoro
alçado	levantado
farraparia	fragalho
enfiar-se	imitir-se
destituído	escasso
imponderado	irrefletido
arcaico	cediço
contestação	negação
farronca	roncaria
enantrópico	endógeno
indisciplinar-se	insubordinar-se
perseverante	persistente
desatar	revogar
adubar	assazonar
anemiar	consumir
acoutar	gasalhar
canal	medianeiro
inadmissão	rejeição
diminuir	suavizar
arregalar-se	esbugalhar-se
glorificar	santificar
cabimento	propósito
complementar	trancar
desconsolado	dessaboroso
murchar	secar
descontinuidade	interrupção
escovar	increpar
enfarruscar-se	turbar-se
acalorar-se	entusiasmar-se
antagonismo	paradoxalidade
palhetar	trotear
alarido	tumulto
desbulhar	privar
pingo	salpico
retrosseguir	retrotrair
impelente	impulsivo
afilar	definhar
represália	vindita
gozar	sotaquear
barulho	ostentação
abalar	tumultuar
desbriado	protervo
estorvar	pejar
ababocado	mazanza
alumiação	iluminação
aliviar	moderar
salubre	saudável
exíguo	minguado
aviso	informe
ardente	caloroso
amofumbar	colorar
desterrado	proscrito
declaração	documento
ajuntar	conchegar
iriante	irisante
abrolho	percalço
amalgamar	fundir
gabo	vaidade
engazopado	logrado
altercar	testilhar
embridar	reprimir
desaferrar-se	soltar-se
abjugar	desaconchegar
barbear-se	raspar-se
erriçar-se	hispidar-se
limiar	origem
encoirado	encourado
desacomodar	dessossegar
cheirar	intuir
persuasível	ponderoso
despedimento	exoneração
aboquejar	caluniar
encurtar	epilogar
acovardar-se	estremecer-se
mania	vício
contender	triscar
atumultar	convulsar
campânula	redoma
encamisada	quê
desvirtuamento	distorção
boucera	tomento
endiabrado	treloso
encruar	encruecer
estendedouro	varal
estopar	madornar
mísero	perverso
palerma	palonço
descortinar	perceber
apertura	rascada
cabortar	carapetar
alcoviteiro	intrigante
rocioso	rórido
agitação	fogo
cabisbaixo	humilhado
inecessário	prescindível
autoctonia	autoctonismo
cadinho	crisol
destristecer	triunfar
amaciar	quebrar
demasiar-se	exorbitar
precaução	prevenção
abarrotado	superlotado
exposição	sujeição
desamparado	retirado
desanimar	torpecer
diadema	nimbo
abrigar-se	cobrir-se
humilhador	humilhante
esticado	retesado
anelo	ânsia
burlante	trapaceiro
festeiro	folião
atrever-se	botar-se
aquietar-se	sossegar-se
prestamente	prestemente
desfear-se	desguarnecer-se
dicionário	léxico
acôntio	seta
chocarrear	rir
assediador	assediante
desatremar	discrepar
cessar	terminar
rapar	unhar
comentação	comentário
exaltar-se	presumir
máximo	tope
impressionante	tocante
apolvilhar	empoar
atirar-se	derrocar-se
desregrado	exagerado
plastrão	plastrom
arrufado	hirto
carapé	pencó
palrar	tartarear
corrugado	engelhado
embaraço	engasgamento
recuperativo	recuperatório
privar	trosquiar
machacaz	machucho
ovniomania	ufomania
refreável	sofreável
converter	transubstanciar
embuçar	paliar
bodum	fartum
alongar	distanciar
enjerizar-se	envinagrar-se
desnalgar-se	remexer-se
sibilo	silvo
arvoado	torvado
raciocínio	razão
concentrar-se	conglomerar-se
continuar	esticar
misantropia	taciturnidade
concupiscência	sensualismo
amachucar	golpear
bravejar	ulular
alardar	galhardear
impedir	pear
bebedeira	embriagamento
afinco	reincidência
destemido	intimorato
paz	repoiso
agulhar	ferir
domesticar	subjugar
abre-ilhoses	saca-bocado
enfadonho	molestoso
folgado	largo
alfaiar	arrear
recesso	retiro
anuviar-se	encangotar-se
animadversão	ripada
aconchegar-se	encolher-se
falhar	fracassar
grugrulejar	grugrulhar
barranca	barranco
pedigonho	pedinchão
refletir	revelar
envenenar-se	intoxicar-se
tremelicar	tremer
aborrecer-se	enjoar-se
abalizado	consumado
placar	retundir
combate	torneio
asnal	beócio
acantológico	mordaz
denodado	desmedroso
estruir	perder
denotação	manifestação
desagasalhar-se	descobrir-se
desfortunoso	mal-afortunado
delgaçar	empalidecer
fechar	impedir
balbúrdia	pandemônio
bambaleadura	boleamento
entelhado	imbricado
afuzilar	esfuziar
estoirar	estourar
adversativo	encontrado
abanamento	agitação
corporalizar	materializar
cortejar	sorrabar
arrefecer	comutar
engoiar-se	escanifrar
dobrar-se	tornejar-se
ilustrar	ornar
colher	lograr
conclusão	conseqüência
bombástico	grandíloquo
cachetar	caçoar
abastoso	adinheirado
absorção	êxtase
preanunciar	prognosticar
balofo	corpulento
aforia	infertilidade
começo	limiar
internúncio	mensageiro
inhenho	maninelo
bumbar	zurzir
estirpe	genealogia
majestoso	venerando
golelheiro	loquaz
derretimento	liqüefação
duradoiro	durável
subsecutivo	sucessivo
elevação	rebitagem
pernaça	pernão
declarar-se	reconhecer-se
gastar	maleficiar
chuchar	sorver
agredir	ir
policiar	refrear
dissipar	malgastar
arreliar-se	irritar-se
infiltrar	infundir
fraco	poltrão
emancipar-se	resgatar-se
aurirrubro	aurorrubro
breve	sinótico
criançada	molecada
ramerrame	rotineira
complexo	implexo
chaleirice	chaleirismo
remar	sobrenadar
acabrunhar	ansiar
berço	pátria
nebulento	nevoento
empalmar	saltear
derrancar	putrefazer
acomodado	digno
repulsar	reverberar
ter	torcer
coscuvilhar	onzenar
faculdade	vantagem
avantesma	visagem
exculpar	exonerar
aferroar	maltratar
apaulado	lutoso
habitação	teto
bambeza	languidez
encolerizado	irritado
mal-aventurado	malfeliz
detalhe	particularidade
atuação	feito
bolçar	regurgitar
pendência	refrega
conselho	recado
assente	determinado
agadunhado	furtado
enxovalhar	impurificar
sobriedade	temperança
amarração	imobilização
limitação	restrição
confortar	fortificar
maquete	modelo
comprazer-se	regozijar-se
desemaranhado	desembaralhado
afumegar	esfumear
malquerido	odiado
alvoroçar	facionar
alimental	nutriente
amolgação	amolgadura
dissipado	estróina
animalizar-se	bestializar-se
pérvio	transitável
afabilidade	suavidade
absolutamente	despoticamente
abortar	malparir
indiscutibilidade	inegabilidade
adoudar	variar
esmiuçar	rastejar
acme	cúmulo
brecar	domar
aplacador	pacificador
exibir	pôr
distender-se	estiar-se
apurar-se	lapidar-se
cafundó-do-judas	cafundório
continuação	decurso
escarmentar-se	flagelar-se
desbriar-se	desconceituar-se
necessidade	nudez
coacto	invito
acalentamento	carinho
pestanear	pestanejar
conhecer	reconhecer
avigorar	potencializar
suprimir	viciar
tramar	urdir
aferar	marfar
esbrasear-se	ruborizar-se
raivento	zangadiço
acachar	amoutar
putrefeito	pútrido
alinhado	nivelado
cifrar	epitomar
desbaratar	esfazer
enrodilhar-se	enrolar-se
adolo	rapapé
volátil	volúvel
infâmia	vitupério
provisional	temporâneo
aferrenhar-se	empeiticar
abduzir	arrancar
ornear	ornejar
embaraçar-se	enredar-se
lusco	vesgo
deflegmador	desflegmador
arrapinar	escamotar
convidativo	tentador
pagodear	rosetar
eternidade	infinitude
vicejante	viçoso
reabilitar-se	remir-se
compreendido	percebido
manifesto	óbvio
acomodar	arrumar
rasgar	transpor
embeberar	transir
procedência	sóbole
refundir-se	reunir-se
popocar	trapejar
primeiramente	primeiro
brincar	divertir-se
encravar	enfincar
exagitar-se	excitar-se
atrair	envolver
renascer	renovar-se
aclarar	expurgar
aclamação	prova
combalido	dessangrado
contrair	murchar
amadurecer	sutilizar
matizado	mesclado
casualidade	esporadicidade
pejar	travar
asnil	boçal
dactilino	datilino
esbravear	mugir
desmoralizar	extraviar
improlífico	infértil
triquestroques	trocado
concernente	respeitante
beleza	diva
deportação	expulsão
esculhambar	infecionar
encarnar	vermelhar
embaraçar	entravar
desfolhar	matar
bordão	cacete
empregar	transtrocar
diversificado	diverso
encanto	prumo
pospontar	ufanar-se
indisciplinar	rebelar
apostemar-se	remorder-se
bufador	vaníloquo
debulhar	escarolar
lembrar	sair
desembainhar	esfolhar
ecoadouro	escoadoiro
vinagrão	zurrapa
franger	pregar
empantufar-se	entufar-se
saca	sacola
cômputo	tento
candelabro	serpentina
eloqüência	expressividade
ameninar-se	rejuvenescer-se
esconjuro	jura
ímpeto	violência
escaldar-se	penitenciar-se
elevar	librar
asperger	despargir
publicar	solhar
arriçar	encarniçar
atar	embirar
dobradiça	engonço
calino	rombo
avermelhar	purpurear
ambicionar	ansiar
agulha	picada
linha	raia
bárbaro	violento
porvindouro	venturo
contrapeso	sobrepeso
abortado	apagado
abafar-se	acobertar-se
engordurar	enlambuzar
delirado	tresloucado
dolente	magoado
demais	intensamente
apatetado	tolo
criptograma	enigma
corte	quebra
arlequim	palhaço
azevieiro	libertino
adivinhador	áuspice
alvarento	entrebranco
desfeitear	ultrajar
diz-que-diz	diz-que-me-diz-que
ocupação	ofício
aborrecer	amaldiçoar
inspeção	visita
benévolo	indulgente
afligir-se	martirizar-se
perspicaz	sagaz
futuro	porvindouro
delonga	prorrogação
munheca	punho
aspiração	idealização
bamboar-se	remexer-se
acróbata	volatim
embaciar-se	lograr-se
segurado	seguro
adjutório	ajudadouro
abaulado	acurvado
acariciativo	amimador
fantasista	quimerista
amarrado	carifranzido
ciscalhagem	cisqueiro
esteira	relheira
enteato	enteu
falador	loquaz
atitude	comportamento
perito	prático
acreditável	crível
esburacar	furacar
despejo	impudor
parco	poupado
alvejar	alvorejar
consumido	consunto
farra	festança
anhanho	lambão
mesurar-se	refrear-se
carnavalear	doudejar
desapoderar	excluir
congelamento	resfriamento
acobardar-se	atemorizar-se
rapace	rapinante
abarbar	sobrecarregar
malandrar	vagabundar
pertransir	transir
conspirar	lambancear
brejeirice	garotice
desbastado	desmoutado
biricera	miudeza
medrar	pular
mastigar	zavar
derriço	namorado
galrar	presumir
debotar	deslavar
descapelar	desencamisar
gelatinoso	pegadiço
conservativo	conservatório
desabrochado	desajustado
demolidor	destruidor
fanfarrice	farfalhice
derrocar	desfabricar
esgotado	moído
alisar	aplainar
levantar	propor
escolho	sirtes
cena	espetáculo
enaltecer	exaltar
sarcástico	trocista
conculcar	depreciar
difundir-se	disseminar-se
asilar	hospedar
desamorado	sanguinolento
destruir	esfrangalhar
empenamento	torcimento
cansar-se	estafar-se
pernaço	pername
irreplicável	irrespondível
beira	vizinhança
simiesco	símio
alucinar-se	endoidecer-se
desconsertar	molestar
enegrecimento	injúria
aviário	aviculário
farejar	profetar
atraso	reversão
galantaria	gentileza
ardentia	fervor
esquisito	estranho
exaustivo	extenuador
consolidação	corporificação
acrescentar	temperar
pestanejar	piscar
abotoar	surgir
assobio	silvo
atravancar	congestionar
desfear	deturpar
acalmamento	mitigação
apedrejar	xingar
apavonar-se	endeusar-se
caturrar	encasquetar-se
surrar	zurzir
missionário	padre
retrasar	retrogradar
bastida	estacada
exacerbar	exasperar
atemorizar	intimidar
extasiado	pasmo
quietar	serenar
desenxavido	dessaboroso
chulice	grosseria
capitalizar	poupar
quebra-luz	refletidor
destrambelho	doidaria
retalhação	sulcagem
desfrutar	motejar
acondicionar	justar
boiante	flutuador
encrudelecer-se	envinagrar-se
ladeira	repiquete
aterrar-se	estremecer-se
caranguejola	casca-de-noz
desvariar	esmaniar
malgastar	prodigar
convir	dar-se
completar	fazer
antes-tempo	antetempo
embaído	engazopado
devoluto	inabitado
prestação	prestamento
depósito	represa
escalavradura	escoriação
agonia	decadência
hermético	intrincado
tratamento	trato
sarjão	sarjel
cariz	celagem
explanativo	explanatório
desaconchegar	vastar
assentar	pressupor
emplumar-se	engalar-se
fantástico	incomparável
deslealdoso	leonino
cambar	dar
devotar-se	votar-se
odorante	perfumado
exaltar	vulcanizar
especificação	particularização
finca-pé	teimosia
retardador	retardante
alvorejar	curar
galhofear	pagodear
fragmentar-se	quebrar-se
constância	insistência
esfalfar	matar
libertador	redimidor
assustar	aterrorizar
dispor	estabelecer
combalir	estremecer
entreter-se	vadiar
amostrar-se	repontar
interceder	terçar
desaparelhar	enfear
desmaiar	esfalecer
calistismo	mofina
bedelhar	cavaquear
alteado	encimado
futuração	hipótese
indecisão	perplexão
denegrir-se	entrevecer-se
afogar-se	melar-se
encarregar	recomendar
afixar	prender
funcionar	trabalhar
determinar	ser
honorários	salário
desentesar	lassear
rodomoinho	voragem
adornar	formosentar
valentão	vaníloquo
haraganear	madraçar
conjecturar	surpresar
apontoar	estear
bestializar-se	embrutecer-se
arborização	arvoragem
apressadamente	rapidamente
bochornoso	sufocante
amelindrar-se	irritar-se
engessar	gessar
rapinhar	tirar
amparo	asilo
pujante	vigoroso
borriço	molinheiro
revel	teimoso
despótico	opressor
coerência	nexo
mudar	transubstanciar
amover	despojar
desencamisar	escamisar
bacia	braseiro
concertar	consonar
arribar	recobrar
entreouvir	sentir
chapa	tabla
vinhago	vinhal
depredar	nivelar
cifra	enigma
agigantado	escomunal
infeliz	queixoso
envolto	revolto
anotar	titular
convincente	eloqüente
assetear	mortificar
detratar	difamar
enrolar	velhacar
gravame	vínculo
dividir-se	partir-se
emascular	enfraquecer
calmar	contentar
autógeno	endógeno
comover-se	desarmar-se
abrir	elucidar
acanhado	covarde
empestado	pestilento
descortês	mal-educado
alimpar	depurar
decriptar	descodificar
estropiar	tronchar
desdoirar	detratar
ditar	ordenar
conchegar-se	unir-se
adulterar-se	perverter-se
guerrear	oprimir
jaruru	macambúzio
cheirante	odoroso
munir	sortir
ajoujar	sobrecarregar
alinhavar	coser
picuetada	pulha
absonar	desatremar
agradecer	gratular
chamuscadura	sapeca
aturar	comportar
entupir-se	fechar-se
abajur	lucivelo
mistifório	mixórdia
amodelar	contornar
esmurraçar	esmurregar
hesitar	titubear
apaulistanizar	apaulistar
modernizar	renovar
habitual	usual
distinguir	honorificar
tartamelar	tremelear
índice	tabela
mandar	traçar
afervorar	despertar
cabeladura	encabeladura
fincar-se	obstinar-se
esconder	guardar
desfeminizar	masculinizar
eliminação	exclusão
aba	beirada
embaçar	engabelar
erodir	rafar
serial	serirário
abaixante	aviltante
lantejoulante	lentejoilante
entristecer	ferir
cumprimenteiro	mesurado
agüentar	segurar
adormecer	atenuar
grânulo	grão
estricto	preciso
onda	turba
descarnar	emagrentar
encoscorar-se	refegar-se
morféico	morfético
flagelar	varar
angurriado	esuriente
anelar	desejar
adjunto	auxiliador
titubear	trepidar
corrido	excluído
mexer	saber
aferrar	aportar
albinia	albinismo
eixo	pivô
cercear	estreitar
corromper-se	putrefazer-se
arrebanhar-se	consociar-se
encoiraçar	encouraçar
arrumação	tessitura
competência	distrito
distanciado	espaçado
atarantação	salsada
cirro	estertor
palpação	tateamento
sensibilidade	subtileza
empavesar-se	envanecer-se
funesto	sinistro
peneirar	sururucar
brotar	propagar
agrupado	associado
desenraizar	desraigar
deslealmente	perfidamente
desvigorizar	exaurir
afoiteza	atrevimento
desanuviado	escampo
mira	objeto
curtir	expiar
ricochete	zombaria
erguer	formar
indocilidade	rispidez
alvo	objetivo
aprendizado	tirocínio
bagunçado	caótico
amolante	paulificante
manzanza	ocioso
chamboado	mal-apresentado
rábido	zangado
abundância	provimento
esganado	somítico
lívido	plúmbeo
derrocada	derruimento
andarengo	andeiro
brutal	desumano
contemplar	refletir
desbaratamento	esbanjamento
desenvolver-se	formar-se
pena	sofrimento
impertinente	inoportuno
pano	tecido
desapossamento	despimento
ostentoso	ufano
agregar	congregar
altear	arribar
abemolar	ceder
arvoar	desconcertar
arrochada	taca
admirável	excelente
degustação	prova
faustuoso	soberbo
abismo	báratro
mélico	sonoro
afobação	azáfama
ocorrer	passar-se
mané	toleirão
contorcer	quebrar
importunice	incômodo
petição	suplicação
achincalhe	ridiculização
porcentagem	teor
infestar	nivelar
adereçamento	decoração
enoiriçar	ouriçar
encangotar-se	escurecer
afagado	mimado
desordem	subversão
despolir	empanar
fúfio	ordinário
escamotear	unhar
nenho	tacanho
arrenegar	descrer
bandarrear	mariolar
desacoroçoado	desmoralizado
horrível	tremendo
empinar-se	engalar-se
embirrância	teimosice
formar-se	operar-se
profusão	superabundância
descarrilhado	desencarrilhado
sórdido	vil
apavorizar	aterrorizar
limpar-se	livrar-se
mentido	mentiroso
cair	desgrudar-se
embater-se	esbarrar-se
facalhão	facalhaz
escapar	escapar-se
antepor-se	repulsar
doação	oferta
abafar	calar
abalienado	delirante
coletor	receptor
inquirir	sondar
brutificar-se	descivilizar-se
decurso	volvido
tesoiro	tesouro
alvor	resplandecência
estroçar	monotonizar
chacota	remoque
escarninho	trocista
amplidão	vastidão
perseguidor	seguidor
rasar-se	tomar-se
combinar-se	concertar-se
hospedaria	pousada
ajoelhar-se	avassalar-se
felicidade	fortuna
estrangulamento	sufocação
arrevessar	lançar
apreensivo	preocupado
falado	insigne
acobertar-se	enroupar-se
entrosar	recompor
faustoso	soberbo
biografista	biógrafo
esvair-se	subtilizar-se
deslustrar-se	obscurecer-se
veludoso	velutíneo
amoroso	caroável
apertar	sotrancar
pudico	recatado
folha	jornal
molhar-se	orvalhar-se
enervação	lassidão
abismado	estupefato
interrogador	interrogante
figurar	retratar
ornar	tecer
pranto	vagido
desassisado	malsisudo
despeitar	encalistrar
acesso	comunicação
repreender	trautear
anarquia	babilônia
aliciar	mordicar
roaz	roedor
efetivação	implementação
sonífero	soporífero
enfezamento	ira
cuitê	porongo
intuir	ver
arrojar	sacudir
celebrização	imortalização
escravizar-se	submeter-se
ondulado	onduloso
gandaiar	vagamundear
embeber-se	empegar-se
alegação	argüição
pigmentar	tingir
coveiro	enterrador
desgaste	erosão
gelar-se	regelar-se
aerífero	aerófaro
enganar	pantominar
hábil	industrioso
dessumir	extrair
ciumento	zeloso
ensoberbar-se	inflar-se
caos	inferno
atracação	embate
riamba	tabanagira
aporretar	derrear
afincar-se	emperrar
bobinar	embobinar
comemorar	revisitar
declamação	recital
cálculo	computação
bobice	ébia
desvergonhamento	petulância
gelosia	rótula
diáfano	pelúcido
arranjar	restabelecer
ferrolhar	subjugar
debilitar	enfraquecer
marmelada	velhacaria
saltarilhar	saltarinhar
ensombrar	enturbar
agrumelar-se	coalhar-se
espécia	especiaria
postergação	procrastinação
desburrificar	desemburricar
asca	enojamento
peita	suborno
beberricar	pingolar
implicativo	implicatório
agastar-se	embravear-se
encobrir	silenciar
rabear	vanguejar
abluir-se	alimpar-se
apurpurado	purpurejante
armação	montagem
brilho	luzimento
açambarcar	atravessar
aleitamento	amamentação
mirar-se	olhar-se
engrunhido	malandro
sebe	tapume
decadência	derrocada
fastuoso	principesco
aplicação	uso
disturbar	estrompar
abobar	idiotar
ferir	vibrar
elegância	glamour
amadurecer-se	assazonar-se
caracolear	volutear
fraude	logro
chafurdar	enlodar
redomoinho	remoinho
fatal	inevitável
reacender	reanimar
acarar	afrontar
deturpar	infeccionar
chatear	destroçar
enxovalhamento	mácula
boiar	patetar
desmembrar	mutilar
encarochado	enfeitiçado
abluir	escorificar
esforçar-se	fazer
bonitete	bonitote
desvendar	expor
longitude	lonjura
entediante	soporífico
legítimo	verdadeiro
barbante	negalho
esmigalhadura	esmigalhamento
adjacência	arrebalde
boquiaberto	pasmado
inópia	pauperismo
atestar	fartar
judiar	magoar
atascal	lameiro
pipitar	taralhar
evasiva	salvatério
apupada	assoviada
trissar	zinzilular
magoar	maltratar
despertar	sacudir
aeração	arejo
rotina	vezo
declarado	ostensivo
botar-se	desembestar-se
bigorrilha	tracambista
aborcar	esvazar
inserido	inserto
ciciar	cochichar
ninar	rolar
incessante	incessável
transverter	trasladar
rolo	vagalhão
afluição	ondada
jactar-se	triunfar
apoquentado	atormentado
desarrugar-se	deslisar-se
encalmar	judiar
furiosidade	veemência
atenuado	langoroso
inclemente	severo
estabalhoado	estouvado
aproximação	encontro
afadigoso	estafante
escabritar	revoltar
prelada	prioresa
batério	beataria
mortinatalidade	natimortalidade
acúmen	fastígio
honra	pundonor
advento	chegada
produto	rebento
embeiçado	enrabichado
semáforo	sinal
exacerbado	irritado
gritada	tagarela
agadanhar	esfolar
fatigar	flagelar
áspero	irregular
carinhoso	doce
ressonadela	ronca
crédito	nome
alvoroto	estrondo
coibir	frear
discrepar	dividir
decepamento	estroncamento
naturalidade	origem
esperdiçador	manirroto
aforrar	cumular
arrepiamento	erriçamento
alíquota	percentualidade
pedacinho	tudo-nada
afuroado	escavado
acomodar-se	adequar-se
humildar-se	rebaixar-se
auspiciar	saber
desamabilidade	impolidez
entrar	vaziar
dealbar	purgar
abrandar-se	amortecer-se
útil	vantajoso
cautela	circunspeção
airoso	digno
altissonante	estriduloso
negócio	ocupação
encangotar	velar
facilitar-se	prestar-se
esfiar	narrar
afã	labuta
moderação	prudência
amanhado	esquipado
corcovar-se	envergar-se
adurir	incandescer
desquadrilhar	sovar
assassínio	morticínio
recalcitrar	repostar
porta-seios	sustenta-seios
dentar	dentear
escopo	mira
batina	samarra
aceder	acrescentar
humildação	rebaixamento
axioma	gnoma
delineamento	esqueleto
aturdir	enzonzar
levado	traquina
intrujar	velhaquear
escarnificar	setear
abafado	enfrenado
cauterizar	confranger
aguilhar	concitar
derrengue	rebolado
talante	vontade
desencerrar	desvelar
arfada	palpite
assombrado	sombroso
aduzir	presentar
elementar	primordial
derrancado	desgarrado
abalançar	estimular
acerbo	amaroso
engelhar-se	franzir-se
albicante	branquicento
desentonar	prostrar
escascar	escovar
goelar	vociferar
desabafar	favorecer
escornar	escornichar
esbravejar	expluir
amassar	marlotar
aliciante	aliciatório
assaltar	lembrar
deprecar	implorar
preluzir	relumar
tórax	torso
prestadio	prestante
guindar-se	subir
arrefecer-se	esfriar-se
luciluzir	raiar
afogadura	afogo
encerrar	enquadrar
nebulado	nuvioso
conceber	meditar
martírio	sofrimento
apresentar	propor
desentender-se	malquistar-se
claudicante	trêmulo
fazer	praticar
focinhada	trombada
manifestar	mencionar
afetação	soberba
degastador	estróina
afofar	envaidar
tufado	tumefeito
recolher	respigar
rota	tenção
dissecar	olhar
desajuizar	descerebrar
brandear	desencruar
chamar-se	qualificar-se
formolado	formolizado
zagalejo	zagalete
incongruente	inconveniente
cobrir-se	turvejar-se
foito	resoluto
extremado	supremo
indignar	marfar
agalinhar-se	estarrecer-se
ancorar	fundear
contraditado	desdito
certame	justa
enfurecer-se	remorder-se
amenizar	remitir
baquear	esfazer
contatar	tocar-se
enganchar	travar
pingar	pingotear
adoidar	endoidecer
difundir	publicar
empedernecer	emperrar
fulgurar	sobrelevar-se
bimbalhar	dar
atirar	disparar
cálido	calmo
culminância	cúmulo
árdego	arrojado
recompor	regenerar
descerimônia	irreverência
recrescer	restar
formidoloso	tétrico
agror	amargura
arreigar-se	inviscerar
canoura	tremonha
esvaziamento	vaziamento
desmiolar	girar
alçar-se	alevantar-se
embrulhada	tralhoada
abio	abiu
albergamento	albergaria
sabujo	samexuga
assegurar	segurar
comida	repasto
cafangar	galhofear
adversar	colidir
exaurir-se	gastar-se
atochar	atrapachar
amorcegar	mungir
intrujar-se	lograr-se
lavrar	rasourar
empinado	encabritado
bacelo	vide
petum	tabaco
frouxeza	moleza
cavalheirismo	galanice
descangotado	enfraquentado
disfarce	ilusão
resistência	subsistência
cravar	embutir
aligeirar	amenizar
contemptível	ignominioso
arte	safadice
infidelidade	rasteira
laxar	safar
capinador	carpidor
contrafeito	violentado
ajaular	aprear
brando	fagueiro
adotar	presentar
infância	meninez
arquejar	lufar
embusteiro	empulhador
preço	vara
abaratar	abaratear
rosa	róseo
demoniomaníaco	demonopata
frescaço	frescalhote
acurar-se	refinar-se
embicar	emperrar
enervamento	exasperação
acossamento	encalço
desmembração	separação
indiscreto	xereta
frenesiar	irritar
bravo	poisio
escassez	míngua
desprovimento	nudez
fixação	gravação
espancar	tundar
jatância	orgulho
aprazenteiro	aprazerado
sufocar	tocar
desencolerizar	desenfurecer
decepcionar	desencantar
asinino	bordalengo
ejetar	expelir
rebaixar	setear
destrinchar	individuar
arteiro	maquiavélico
honestar	ornamentar
compactar	compendiar
exacerbar-se	malignar
bufo	cômico
saracoteamento	saracoteio
escarnecido	escarnido
enquadrar	possuir
gracejar	joguetear
vagamundear	zaranzar
aperceber	entabular
campônio	rústico
contextura	traça
brusco	inesperado
empanturrar-se	engalar-se
intrigar	onzeneirar
golfar	verter
averiguação	estudo
abonançar	apacificar
afago	favorecimento
cabeço	outeiro
coalizar-se	consorciar-se
aguar	lentar
querença	querência
desavezar	desvezar
fabular	mangar
anêmico	frouxo
perturbador	perturbante
divorciado	quite
teleconduzido	teledirigido
abeirar-se	unir-se
abaçanado	trigueiro
cacoete	tique
alevantar	erguer
bagunçar	pandegar
amputar	cercear
heroísmo	hombridade
bagualada	incivilidade
decesso	perda
fragmentar	partir
aforado	enfiteuticado
confirmador	confirmativo
enervar	exagitar
rejuvenescer	renascer
desgargalado	esgargalado
deter	represar
desapreçar	desapreciar
arroubar-se	embevecer-se
interrupção	travamento
roncar	rugir
abertura	vau
agasalhado	enconchado
apropriado	próprio
insulado	isolado
estranhar	ralhar
designar	preceituar
enfenecer	selar
afinar	polir
manchar	poluir
enraivecer	escandescer
imortalização	notabilização
cortesia	delicadeza
desagastar	desassanhar
barreirar	envalar
oportuno	propício
destroçar	dissipar
sobre-restar	sobreviver
distinção	realce
igualizar-se	uniformar-se
comunicabilidade	comunicatividade
conglobar-se	congregar-se
pelar	rapinar
alegria	júbilo
frustrado	vão
estacional	imóvel
asqueroso	balordo
danificar-se	inutilizar-se
retinir	zinir
estralar	pipoquear
apercebido	providente
desistir	escorraçar
mentir	ocultar
aguçado	apuado
desobedecer	trespassar
banzado	pasmado
robustecer	tonificar
fraturar	quebrar
desentoado	discorde
enfastioso	enjoado
inflexibilidade	rudeza
ecúleo	flagelo
buscado	procurado
destrutibilidade	fragilidade
limo	vasa
desajustar	despegar
biraia	megera
canhoneio	fuzilaria
desdenhar	minimizar
atrapachar	ingurgitar
atocaiar	esquadrinhar
desfalecer	esvanecer
colimar	mirar
hidraéreo	hidroaéreo
rubescer	ruborizar
divisado	estremado
engalhopado	escarnido
gloriar-se	timbrar
linguarado	linguarudo
insaciável	voraz
eterno	imperecedoiro
desvirtuar	violentar
escandalizar	ferir
desmaio	vágado
escouceador	escoucinhador
asfixiador	asfixioso
beleguim	quadrilheiro
baixar	cortar
petimetre	pimpão
entreter	negacear
estrelar	fuzilar
embaciado	rofo
aprontamento	aprontes
absorvedoiro	tragadouro
alcoólatra	bebum
avolumar-se	espessar-se
desvitalização	esgotamento
carpidor	mondador
demasia	desmedida
afrontar	estrompar
temido	valoroso
gentil	prazenteiro
desadorado	renegado
engranzagem	entrós
chamego	galanteio
azoratar	desarvorar
misto	mistura
apoucar	decair
badulaque	penduricalho
concórdia	confraternização
manar	vir
aplacamento	contemporização
desacoroçoador	desconfortador
apropositar	justar
audaz	longânimo
cabuetar	entregar
condenar	desadorar
biltre	vilão
garrular	prosear
intricado	obscuro
decremento	decrescimento
conservação	salvaguarda
temperar	toar
molengão	molengo
alcachinar	tornejar
despreguiçar-se	estender-se
careta	visagem
enlamear-se	pandilhar-se
empacar	entrelaçar
desfraldar	esfraldar
guarir-se	reerguer-se
emborque	esborro
abstração	alheamento
candente	nitente
noctambulante	noctívago
ônus	pensão
purificar	virginizar
contumélia	insulto
cotização	rasca
rasto	rieira
geral	unânime
extrato	fragmento
entesoirador	tesaurizador
feio	insuportável
bêbedo	tonto
mancar	manquitolar
ficha	registro
afiançar	assegurar
arrelioso	rusguento
manear	superintender
esfrangalhar	farrapar
atônito	tolo
disciplinar	sujeitar
chocalheiro	intrigante
cogitar	ponderar
encabulado	vexado
descaído	elanguescido
babujar	borriçar
amassado	espandongado
aviventar	reanimar
arrotar	galhardear
acoucear	agredir
animosidade	desinteligência
desonerar	liberar
envolver	reprimir
repenicar	tanger
barraca	tenda
fingidamente	simuladamente
aspado	aspeado
desacorçoador	desacoroçoador
aferir	balançar
desbordar-se	desenfrear-se
arpear	arpoar
amadurado	assazonado
pacífico	sossegado
tarelo	vozeiro
decaimento	degenerescência
atro	hórrido
liqüidar	perfazer
romper	rotura
desleitado	exúbere
alarmar-se	espaventar-se
aparência	cara
quietitude	repouso
desafinado	discorde
pimponice	rebolaria
caracterizar	descobrir
amolador	maldito
desajuntar	desajustar
apoucado	triste
exemplo	lição
domiciliado	morador
aformosar	vestir
cainho	esganado
filtrar	procurar
esplêndido	esplendoroso
lógico	producente
crescer	progredir
baiuqueiro	taberneiro
esfoguear	pruir
procriar	prolificar
macaquear	repetir
colônia	protetorado
arfadura	arfagem
raposia	viveza
compulsão	empurração
galarada	ramagem
entornar	estragar
borradela	nódoa
torração	torragem
aboletar	agasalhar
estralejar	pipoquear
amparar	estacar
freqüente	ininterrupto
consistir	repousar
estrondear	troar
encravelhar-se	encravilhar-se
briga	turbulência
escorificar	expurgar
arrostar	desafiar
canhestro	esquerdo
simplez	simpleza
equalizar	uniformizar
estadear	ostentar
ermo	tebaida
amoldurado	emoldurado
delongar-se	prolongar-se
desmelindrar	jubilar
mesmo	próprio
desadmoestar	desaferrar
capação	mutilação
afainar-se	azafamar-se
expandir	veicular
banzativo	penseroso
babaré	babaréu
decepar	estropiar
memorando	memoroso
elevado	empolado
acalmar	retundir
amoitar	ocultar
assolação	vastação
envilecedor	rebaixador
descrição	reprodução
prender-se	sujeitar-se
desacerto	mal-entendido
estupefazer	pasmar
criançola	dunguinha
adunar-se	ajuntar-se
abalizar	assinalar
outar	peneirar
bravio	encapelado
dirigir	reger
comparte	sócio
apuro	embaraço
decrépito	descaído
desluzir	mutilar
comparecimento	presença
clamador	gritador
desacautelar-se	desprecatar-se
deletério	pernicioso
opiniativo	problemático
transmissivo	transmissor
agito	alvorotamento
juventa	juventude
absurdo	incoerente
asfixiar	reduzir
embandeirar	nobrecer
arcaístico	perempto
debique	mangação
transmitir	transmitir-se
estufar-se	tumefazer-se
cativar	confinar
sobressaltar	transpor
enxurdeiro	tujucal
alfombrar	entapetar
enverdecer	verdejar
acampamento	rancho
compendioso	resumido
convencer	encasquetar
contaminação	estrago
aquedar	paziguar
manjadoura	manjedoura
conglutinar	congregar
diferir	retrasar
desvão	recanto
aferro	agarração
aglomeração	concentração
embromar	palhetear
anunciação	participação
folhado	folhagem
mal-entrajado	malroupido
recuar	refugir
acatingado	catingoso
adereçar-se	ataviar-se
bordejar	nutar
alfeninado	dengoso
adversão	tribulação
berro	urro
ariscar-se	assustar-se
bestificamento	emparvamento
astuto	finório
entrincheirar	valar
abaratear	rebaixar
contérrito	surpreso
aporreamento	raladura
andado	decorrido
difusamente	largamente
ajuizar	reputar
monja	professa
prescindível	supervácuo
desmentar	enloucar
sobrelevar-se	sobrepujar
rezingar	testilhar
embravecer-se	esturrar-se
engalfinhar-se	rolar
insistir	pisar
conferência	conversação
acachapar	subterrar
esmaniar	tresvariar
buracada	buraqueiro
excruciar	torturar
profetar	saber
grandeza	intensidade
encadear	trincafiar
eruginoso	ruvinhoso
amaricado	aqualirado
folia	noitada
blasfemo	insultuoso
azedar-se	desenfrear-se
alentar	ansiar
enfustar	especar
jatante	vanglorioso
desenlamear	mundificar
desenvolto	inquieto
desperecer-se	deturpar-se
desarranjar-se	descompor-se
rebramar	ressoar
brutalizar	exulcerar
alcovitar	mexericar
áscua	faúla
empestear	pestear
desservido	escasso
meretriz	mulher-do-fandango
averso	desafeto
aperto	miséria
astucioso	espertalhão
banal	nulo
cicatrizar	sarar
deslustre	empanamento
alistar	relacionar
encafifar	tungar
atualizar	renovar
gândara	gandra
agradar	alegrar
atraente	fascinante
imponente	pretensioso
tosar	trosquiar
esfolhar	exterminar
ensaiar	industriar
escandalizar-se	picar-se
arengar	pugnar
desanelar	desencanudar
clareação	dilucidamento
advogar	patronear
espevitar-se	incitar-se
concernência	pertinência
altíssono	estridoroso
travento	travoroso
atilar-se	sazonar-se
curteza	tacanhez
engrimpar-se	lisonjear-se
gordurento	graxo
resguardar-se	tapar-se
coruchéu	píncaro
semideiro	vereda
pernejar	transpor
chocar-se	embater-se
circulação	giração
endurar-se	petrificar-se
doente	paciente
invenção	rodízio
disparatar	sonhar
agoniar	ansiar
abetumar	argamassar
residir	ser
acoroçoar	esperançar
vivaz	vivedor
insubordinação	rebelião
exibição	ostentação
humildade	pobreza
acumular	coacervar
adivinhação	predefinição
corroído	desgastado
alienígena	estrangeiro
inteirar	trancar
ablegar	mandar
afinado	purificado
derribamento	esbarrocamento
amolestar-se	escandalizar-se
nefando	réprobo
dissimular-se	mascarar-se
endoudar	soçobrar
imiscuição	ingerência
incitação	provocação
desadoração	execração
atesar-se	entabuar-se
placidamente	tranqüilamente
encontrão	topada
flato	flatulência
desraizar	jugular
apresentação	cara
anano	anãzado
assoado	esmoncado
levantador	revoltador
delucidar	instruir
desfibrar	examinar
inconveniente	inoportuno
alcofar	intrigar
adquirimento	obtenção
afortalecer-se	retemperar-se
conglobação	conglomeração
desmando	exageração
peguento	visguento
entesar	esticar
retaguarda	traseira
espinoteado	estouvanado
magnanimidade	nobreza
defloração	desvirginamento
desajustar-se	desavir-se
comer-se	dilacerar-se
engorovinhado	espadongado
airosidade	donaire
nomenclatura	relação
chibatear	vergalhar
charlariento	palavreador
divulgar	preconizar
prudente	sensato
espantado	sobressaltado
pantalha	tapa-luz
desagravar	desinchar
moganguice	monada
vigiar	zelar
ondeante	ondulatório
acambetar	coxear
molha	molhadura
apicaçar	puxar
preliar	reixar
antro	fojo
aquecer-se	chispar
encobrir-se	obnubilar-se
hipótese	vislumbre
dissuadidor	dissuasor
dançar	sapatear
pubente	pubescente
ladainha	lengalenga
ecoar	retinir
localista	lugareiro
reboante	retumbante
cuidoso	vigilante
repoiso	sossego
arremessado	desconsiderado
remeter	saltear
controverter	questionar
escapar-se	livrar-se
esbregue	pito
acarpetar	entapizar
entenebrecer-se	negrejar-se
altanaria	sobranceria
jangalamaste	zanga-burrinha
ampliar	dilatar
alternar	rajar
lerdo	tardo
abeberar	desalterar
amoldar-se	formar-se
traquinice	travessura
lacerar	magoar
enfracado	extenuado
fundir-se	submergir-se
enojar-se	entediar-se
acostumado	aquilotado
desenterroado	esterroado
cobrador	recebedor
anarquizar	destemperar
moribundo	morrediço
infernar	tempestear
carimbar	divisar
reduzir-se	sujeitar-se
crispar-se	embabadar-se
impetar	pinçar
expor	submeter
palúrdio	patola
infernal	leteu
justar	pactuar
bulcão	redemoinho
cavalgar	cavaloar
egrégio	ilustre
amagrado	amumiado
superar	trasmontar
desentristecer-se	destristecer-se
marejar	porejar
badó	chapetão
ascendência	predominância
calcinar	queimar
desarticular	esnocar
desemaranhar	esclarecer
caricioso	carinhoso
alindado	esquipado
bajular	lamber
oásico	oasino
opíparo	opulento
adoçante	edulcorante
arrebatamento	fogosidade
aguçar	influir
relacionar	unir
autopsial	autóptico
desesperar-se	rasgar-se
indefectibilidade	perfectibilidade
amarasmado	mazorro
extrair	intuir
absorciso	absortivo
predizer	prenunciar
espetro	simulacro
espacejar	procrastinar
descolorar	descorar
adaptar-se	moldar-se
subordinar-se	torcer-se
monumental	rico
carolo	coque
hospedagem	pousada
escorraçar	espancar
embolso	remuneração
dar-se	ocasionar-se
abrasamento	adustão
foto	retrato
fugida	retirada
despistar	emburricar
aleiloar	leiloar
embarrado	esbarrado
mungida	ordenhação
amor-próprio	auto-estima
desapreciar	desmerecer
redepositar	repor
soez	vil
aventuroso	bendito
desfrisar	desguedelhar
enjoado	soporífero
enfezar	massacrar
dilacerar	esfarrapar
mangar	pilheriar
augusto	brilhante
entrepor	intermeter
reeditar	reestampar
cínico	impudico
rachadura	trinca
apestar	viciar
palhetear	zombetear
diligência	ligeireza
deslustrado	empanado
corruptível	corruto
tapeçaria	tapete
competidor	contendor
lidar	mexer
avanço	vantagem
alargar	alongar
comum	corriqueiro
baderneiro	badernista
engordurado	enlambuzado
entorpecer	imotar
preexcelso	sobreexcelente
dolo	tábua
incompreensível	inexplicável
caliginoso	obscuro
mudança	mutação
sagrado	venerando
acidentar	lesionar
entreabrir	florir
azorragar	chibatar
soronga	tolo
capitoso	opiniático
sambador	sambeiro
assemelhar	parecer-se
fonógrafo	gramofono
oscilar	trepidar
depravar	sofisticar
despistamento	ludíbrio
reparar	sanar
cerrar	juntar
avareza	mesquinharia
velamento	vigília
serpentante	serpenteante
agraciação	galardoamento
apancadado	tonto
embaçado	logrado
cagüetar	delatar
láteo	laticinoso
encíclico	redondo
dama	dona
inoportunidade	intempestividade
colocar	propor
forma	talhe
entendido	percebido
fantasmagoria	visagem
arrebentar	desabar
acalantar	mimar
adejar	jogar
zanaga	zarolho
trapeziforme	trapezoidal
gorjeta	molhadela
derreado	esquadrilhado
alterar-se	transmudar-se
esquartejado	retalhado
bestice	burricada
pife-pafe	pif-paf
altiplano	platô
ajaezado	esquipado
desterroador	estorroador
conto	dito
cismarento	penseroso
surripiar	surrupiar
destemperado	imoderado
caroável	prazenteiro
improdutivo	infrutífero
chilro	trinado
embustear	gambelar
contradito	desmentido
achincalhação	achincalhe
antibrômico	desodorizante
descravejar	desencastoar
cambetear	mancar
amorenar	atrigueirar
enegrecer-se	entrevar-se
esbodegado	estragado
enviesar	inclinar
desprazer	ofender
acovardar	atemorizar
ponxirão	putirão
caraterizar	desencobrir
foragido	homiziado
espinhar	exaltar
pré-escolar	pré-primário
esbarrondadeiro	resvaladoiro
indignar-se	irar-se
fontanal	fontano
enrijecer-se	retesar-se
constituir	deixar
extra-humano	ultra-humano
obstinação	teimosia
magnificente	triunfante
assistido	auxiliado
acendrado	apurado
confeitaria	doceria
ababelar	unir
complicar	enlear
prolóquio	refrão
fracalhão	medroso
informar	inteirar
bainhar	bordar
rega	regadura
arrincoar	estacionar
enrolado	rolê
tomadiço	zangadiço
arvorar	ostentar
deleitação	prazer
inflar	tumescer
bacorinho	leitão
emblema	signa
emborquilhar	transvazar
predominação	supremacia
achar	desentesourar
revitalizar	roborar
combustar	inflamar
adversor	antagonista
distrair-se	dormir
desenfrear-se	envinagrar-se
porfiado	porfiador
avir	enlaçar
ajustar	conluiar
apascentar	espairecer
desolar	ermar
incidir	inflectir
predefinição	profecia
adaptação	conformação
extravagância	ratada
desafogar-se	expandir-se
integralizar	reunir
bacharelada	bacharelismo
candongar	pajear
desvanear	varrer
trinfar	trissar
amostrar	indicar
sumarento	sumoso
essência	substância
encasquetar-se	teimar
arrupiar	enoiriçar
bulir	comover
plantação	plantio
escrever	insculpir
coscoro	crusta
compensar	pagar
castigo	reprimenda
queda	tombo
desembebedar-se	desemborrachar-se
aboriginal	crioulo
devolver	tornar
aliviado	leve
atufar	entupir
incensação	incensadela
admitir	permitir
farfalhada	rumorejo
ajustado	pactuado
bazófia	ostentação
desejador	desejoso
ansiar	later
contractível	contrátil
acariciar	mimosear
envilecer	rebaixar
desenfrenar-se	espinhar-se
endoidar	ensandecer
esperar	ficar
pacóvio	simplório
conciliar	enlaçar
desrespeitar	transgredir
negligência	ronceirismo
honrar-se	prosear
permitir	suportar
combatente	militar
ajustar-se	combinar-se
entabular	incoar
pardaço	ruço
maneira	técnica
malvado	nefando
sobrevir	suscitar-se
álveo	leito
rafaelista	rafaelita
escangalhado	espedaçado
mordiscar	soprar
agravar	recrudescer
assiduidade	presença
balancear	comparar
capucho	insociável
armipotente	mavórtico
envencilhar	jungir
personalizar	pessoalizar
desenvolver	vingar
montão	ruma
adelgadar	renegar
desembocar	vaziar
acanalhar-se	desonrar-se
amortecer	placar
dourar	entusiamar
aparamentado	ornamentado
desfeiteado	injuriado
correção	pena
bambalear-se	rebolir-se
libidinagem	volúpia
desafetado	lhano
afincamento	tenacidade
desarrochar	suxar
mavórcio	mavórtico
afazer-se	costumar-se
atoleiro	tijuco
afirmar	implantar
desarmar	desconjuntar
proximamente	recentemente
afroixado	largo
enfunar	pojar
esquipado	guarnecido
algaraviada	celeuma
lanoso	lanudo
desleixação	relaxidão
comissionar	recomendar
arrependimento	metanóia
coibir-se	mesurar-se
educar-se	polir-se
esquivar-se	eximir-se
capelo	chapeirão
alteração	indignação
desumidificar	esgotar
ataviar	ornamentar
chegar-se	conformar-se
achacado	corrompido
apontamento	indigitação
abichado	bichoso
adstritivo	estíptico
acidável	acidificável
agilidade	dinamismo
ataque	salteada
atrapalhado	avoado
peraltice	tafularia
contexto	tese
investida	remetida
embrincar	moldurar
guarnecimento	guarnição
desestimar	menosprezar
baboso	lambão
hastear	tender
enfurnar	enlocar
descansado	repousado
aliado	associado
jurar	maldiçoar
bajoujo	parvo
cimélio	raridade
repetição	retumbo
circunspeto	recatado
encafuado	encoberto
provento	vantagem
julgar	olhar
confusão	tumulto
esquírola	estila
absimilhante	dissemelhante
imaginar	suscitar
rebuçar	velar
enroscamento	parafusação
palpar	tocar
ovniológico	ufológico
desconhecedor	mal-agradecido
pio	religioso
lição	repreensão
editoração	publicação
abençoar	bendizer
noticiar	reportar
consideração	deferência
asfixiante	asfíxico
beataria	beatismo
querer	vontade
desajoujar-se	desligar-se
rameloso	remelão
convivência	convívio
furar	transir
anojoso	nojoso
aposento	morada
desembebedar	desembriagar
alhear	traspassar
desandar	tresandar
alívio	minoração
aluminífero	alúnico
poderoso	soberano
abonançar-se	sossegar-se
arrevesar	inverter
aposta	jogo
enforcar-se	esgoelar-se
abertal	abertiço
compatibilizar	reunir
assediar	enrolar
consumar	efetivar
desenroupado	desnudo
desluzir-se	embaciar-se
tesauro	thesaurus
úmbrico	umbro
chupar	libar
corpulência	espessura
saçaricar	sururucar
avérneo	infernal
acaiçarado	alarve
amachucado	depauperado
abril	juvenilidade
luziluzir	pestanejar
ignominioso	indigno
avaliar	enxergar
sombreado	sombroso
embodegado	lixento
absolvição	indulgência
expelido	expirado
fastoso	suntuoso
final	improrrogável
delinear	esboçar
emperlar	perolar
mais	restante
fuxicar	onzenar
desconchegar	destruir
congelar	regelar
derrapante	escorregadiço
desamarrotar	desenxovalhar
acaçapar-se	acovar-se
baiúca	bodega
pedir	vindicar
encolher-se	resignar-se
encarrancar-se	obscurecer-se
revir	vogar
resplendecer	ressaltar
caução	fiança
desmoronar-se	esfarelar-se
cartório	tabelinado
radiógrafo	radiologista
desarraigar-se	extirpar-se
latejar	later
censurado	reprovado
pintar	retratar
notar	verberar
transformar-se	transmudar-se
fermentáceo	fermentante
expelir	rojar
comportar	permitir
agitador	agitante
alborotar	desassossegar
perdido	submergido
pescar	tomar
espinhal	espinheiral
impersonalidade	impessoalidade
troçador	zombeteiro
adergar	falar
amoriscar-se	apassionar-se
entupir	tapar
junco	verdasca
melanoxanto	melaxanto
obsidiar	rascar
passeio	volta
aterrorizador	terrorizante
descuidar	transcurar
forçado	violentado
salvar	saudar
subdiretor	vice-diretor
emparelhar	empatar
avexar	torturar
enxundiar	nutrir
acérrimo	teimoso
iriar-se	matizar-se
coroar	eleger
acobertar	roupar
embonecar-se	engalanar-se
agonizar	boquear
bambolear	sacudir
sinal	traço
quilatar	tomar
alçar	exaltar
desentumecer	desintumescer
lorota	poeira
avassalar	superar
grosso	mal-educado
desgregar	erradicar
cavalariça	persigal
adido	amparado
casquilho	puxadinho
aceitar	subscrever
curvo	inflecto
detrair	infamar
bofetear	estapear
agremiar-se	juntar-se
consociar-se	reunir-se
aluvião	enchente
indenizar	remir
massamorda	miscelânea
conduzir	vibrar
fogoso	impetuoso
comunicar-se	contatar
sorver	varrer
chalaçar	pagodear
cevo	engorda
interesse	provento
rojar	sacudir
falecer	necessitar
vivenciar	viver
desencarregar	desobrigar
caçoada	trote
berrar	estrilar
perfeição	precisão
distinguir-se	predominar
esconjurar	repelir
comensurar	igualar
alma	vivacidade
apunhar	manear
assazoar	revestir
devaneador	sonhador
moderado	temperado
propósito	vista
desencalmar-se	sossegar-se
precação	súplica
alfandegar	alfandegueiro
alvescer	calear
estourar	estrugir
devagar	morosamente
aturado	seguido
atrocidade	monstruosidade
ambrosiado	delicioso
focar	salientar
abolir	esfazer
bençoar	favonear
ataviado	engalenado
aflorar	frolar
trapaceador	trapacento
alojar	condessar
abstrato	alheio
comprazer	releixar
borrifar	serenar
afável	amorável
encimar	remontar
enfaro	repugnância
aleta	narina
amamentação	lactação
ininterrupto	sucessivo
ensejar	produzir
enfastiar	fadigar
ambulante	erradio
chato	liso
amotinação	levante
incapaz	inválido
especioso	vão
aflito	apertado
agoniado	amargado
acirrante	exasperante
cascorriento	perebento
estrelante	rutilante
aldravice	trapaça
ditadura	prepotência
abraçamento	amplexo
dunguinha	rapazola
acentuado	saliente
exsicar	ressecar
abandonar-se	descurar-se
delatar	patentizar
gabador	rebolão
atestado	atulhado
encobertar	tapar
arroxeado	roxeado
despedir	rutilar
descasar-se	separar-se
calo	tiloma
esgote	exaustão
detestado	execrado
dificuldade	obstrucionismo
samexunga	sendeiro
afogar	dependurar
adicionado	aposto
parodiador	parodista
arrogante	corajoso
enevoar-se	ensombrecer-se
inserir-se	introduzir-se
parado	suspenso
combinado	determinado
multipontuado	salpintado
entrezar	travar
sangrador	sumidouro
aloucado	amalucado
buraco	hiato
báratro	sorvedoiro
painel	palco
calafetagem	calafetamento
aleatório	inopinado
cinzelar	gravar
cachaceiro	ebrioso
acatar	aceitar
encruado	indigesto
enlevado	inebriado
alvoroçado	alvorotado
trave	travessa
evidenciar	expirar
anulável	nulificável
espanto	sobressalto
desagoniar	desapertar
jactancioso	presunçoso
envolver-se	implicar-se
amor	carinho
impetuoso	veemente
acovar-se	amoutar-se
falace	frustratório
castrar	mutilar
abreviadamente	laconicamente
acafelado	encoberto
desajustado	solto
encruentar	tesar
tapadura	vedação
piscar	reluzir
advir	realizar-se
apalear	aporretar
conchavar-se	mancomunar-se
aquietar	pacificar
urdidura	urdimento
degenerar-se	estragar-se
discordante	inarmônico
deliciosamente	saborosamente
aqueronteu	trevoso
estimar	jubilar-se
desatracar-se	soltar-se
disparar	pregar
cavoucar	escavar
liquidado	líquido
canseira	fatigamento
cordial	fagueiro
asco	enfaro
oirejar	ourar
desconforme	monstruoso
impelir	prurir
malicioso	travesso
acanavear	dilacerar
arrabalde	subúrbio
aposentar	recolher
intáctil	intangível
escarpamento	talude
tonitruante	tonítruo
abnoitar	dormir
endocelular	intracelular
bronco	calino
distanciador	espaçador
capangada	jagunçaria
bofetão	munhecaço
obstáculo	transtorno
surpreendido	surpreso
engalar-se	envanecer-se
esborcelar	esbrucinar
preservar-se	salvaguardar-se
esforçado	estrênuo
burrego	burro
agregação	associação
cerro	outeiro
espiolhar	vasculhar
conflito	embate
descontaminar	despoluir
ressaio	rossio
farnel	merenda
esmolambado	pelintra
tinir	tremer
tenebrosidade	véu
parolear	tartarear
atreito	chegado
lassear	laxar
fixador	fixante
acravar-se	espetar-se
ansiado	cobiçado
valentia	veemência
arruá	atravessado
encenação	fantochada
condição	condicional
descender	ser
bagatela	nada
espraiar-se	esticar-se
migado	picado
batoque	gargaleira
domar-se	vencer-se
amesurar	mesurar
aniquilar-se	evaporizar-se
assomado	atrabilioso
depravado	ruim
decorticação	descascamento
correntio	costumeiro
sair	suceder
perlar	perolizar
lameirento	pantanoso
entregar-se	vagar
abominar-se	aborrecer-se
arrazoado	razoado
ferimento	raspão
dispensa	dispensação
jigajoga	ludíbrio
assentado	encravado
atitar	ciciar
respiradoiro	suspiro
cismativo	imaginativo
estupeficar	pasmar
engatado	unido
agalanado	esquipado
destroçado	dispersado
conturbado	revoltado
gula	gulosice
esforço	luta
despeitado	escandalizado
compromissar	meter
aplacar	serenar
aquisição	conquista
mica	migalha
delir	fundir
embevecer-se	encantar-se
conceptível	perceptível
acoitar-se	entroixar-se
engrimpinar-se	pavonear-se
indeclinabilidade	irrecusabilidade
escurecer	marear
buído	safado
imutável	irrevogável
dinheirento	opulento
apupado	assoviado
escola	imitadores
acarinhar	mimar
esconjurar-se	querelar-se
esmerar-se	timbrar
duradouro	perdurável
espantar	surpreender
incitar-se	rabiar
aflechar	susceptibilizar
fingir	furtar
desconhecimento	insipiência
macacal	simiesco
espírita	espiritista
prodigioso	tremendo
militância	oposição
defensor	padroeiro
sentir-se	tornar-se
entontecer	zonzar
arcado	arqueado
foguete	rojão
sussurrar	zinir
lapidificar	petrificar
didático	escolar
acossar	confranger
acalento	alívio
bordar	broslar
comumente	vulgarmente
decepado	seccionado
amotinar-se	insubordinar-se
chão	manso
aramista	equilibrista
desbandalhar	estrinçar
evolar-se	liberar
brincalhão	engraçado
desinquietar-se	incomodar-se
fonte	motivo
ser	suscitar
brumaceiro	nevoento
estulto	pateta
farelo	rebotalho
benefício	graça
enfeixar	entroixar
descabelado	tolo
demolir	rebaixar
acender-se	vulcanizar-se
razoar	sustentar
alparcata	alpercata
embrumar-se	encangotar-se
acúmulo	montão
escalar	saquear
gear	gelar
estapafúrdico	estapafúrdio
lourecer	lourejar
anojado	enfastiado
palavrear	palrar
enceleirar	poupar
refolhamento	rufo
palustre	pantanoso
consunto	gasto
empeçonhentar	estragar
consociar	reconciliar
adormecido	repousado
carpir-se	lamuriar-se
risca	traço
chicanista	rabulejador
entrajar-se	tratar-se
embrulho	encravação
hospitalário	nosocomial
impassível	inalterável
quebrado	violentado
escuridão	negrura
praxe	usança
deixa	oportunidade
apear	desfabricar
par	parelha
glanduliforme	glanduloso
aluado	destrambelhado
calejar-se	obdurar-se
consolidar	estipular
altareiro	beato
obstinado	persistente
desiludir	despersuadir
presumir	vislumbrar
apacificar	desencrespar
danação	estrago
aviltador	degradante
desarmonioso	malsoante
apossado	apropriado
assolapar	desmelhorar
envasadura	envasilhamento
desproveito	prejuízo
desapropositado	inoportuno
rejeitado	repelido
bem-aventurado	fortunoso
erector	eretor
enredear-se	intrincar-se
afaluado	afobado
igualizar	respaldar
escadeirar	zurzir
alfinetada	sainete
desarticular-se	desunir-se
danar	empeçonhentar
engano	engodamento
levantar-se	virar
donzel	singelo
escapamento	escoamento
opar-se	tufar-se
aquiescer	assentar
ativado	excitado
ablução	limpeza
palpitar	perquirir
ressicar	secar
mamar	velhacar
enfatuado	jactante
aflautado	delgado
ancípite	indeliberado
tratantada	tratantice
seccionado	tronco
conjurar-se	rebelar-se
consolação	consolo
germe	princípio
congeneridade	semelhança
retardação	retarde
escaldar	incendiar
infectar	profligar
auspício	predição
espenicar-se	ornar-se
embarreirar	fortificar
despejar	transvazar
desperdiçador	esperdiçador
desentaipar	desentulhar
antelóquio	prefácio
enxovalhado	infamado
atuar	sugestionar
dicionarista	lexicógrafo
grandaço	grandalhão
atontar	estontecer
aferrolhar	enclausurar
planta	traçado
horrífico	horrível
acalmar-se	placar
arrimar-se	jogar
esgoelar	estrilar
abismamento	assombro
colheita	safra
apodo	zombaria
ajutório	putirão
desassossegado	estavanado
macotena	morfético
cortês	educado
elanguescido	enfraquecido
bramoso	furioso
lavoira	lavragem
esplendorar	rutilar
diferençar	ver
namoradeiro	requestador
chibante	jactancioso
bem-parecido	bonito
sanguinoso	subumano
barda	tapagem
arranjado	organizado
indigno	refece
acometimento	saltada
cesura	corte
granja	quinta
apoltronar-se	refestelar-se
túnica	tunicela
açúcar	suavidade
bolear	esmerilar
lei	ordem
amorável	querençoso
acirrar-se	exasperar-se
assinalar	impor
rebocadura	reboque
arcebispado	arquidiocese
manco	rombo
extremismo	radicalismo
lograr	sofismar
desfrute	moca
finar-se	findar
lufa	rabanada
malífero	malsão
produtivo	rico
dessegredar	pregoar
caramunhar	chorincar
desencontrado	discordante
bebida	líquido
desaguar-se	verter-se
humilhação	ofensa
clínico	terapeuta
ditinho	intriga
altear-se	subir
aconchavar	ajustar
alanzoar	parlar
agrestice	incivilidade
escoicear	respingar
apeçonhentar	desvirtuar
desmancha	esborôo
grandalhão	grandão
conciso	condensado
laivo	vislumbre
disposição	tendência
ágil	despachado
calvinista	presbiteriano
amarar	angustiar
engavelar	faxinar
chaleirar	lisonjear
enfurecido	irado
mulher-perdida	prostituída
angelical	angélico
aviltar-se	injuriar-se
atassalhado	espedaçado
limar	policiar
assistir	demorar
beberes	bebes
conglutinoso	pegajento
gênero	jaez
carro	veículo
proprietária	senhora
circundamento	rodeamento
intermeter-se	permear-se
adstringir	dobrar
enfunação	inchação
candongueiro	lisonjeador
excluso	repelido
açude	mota
beliscadura	morsegão
abarracado	acampado
profícuo	proveitoso
arduidade	laboriosidade
infecto	pestilencioso
meigo	simpático
caminho	trilho
enxame	pelotão
abarracar	acampar
anódino	fútil
operar	proceder
confabular	falar
casto	ingênuo
beber	libar
seviciar	torturar
cachaça	pinga
abatocado	atapulhado
aparvalhado	extasiado
comezinho	humilde
beneficiário	favorecido
pensionário	pensionista
esmaecer	extinguir-se
inundar	submergir
cabrocar	segar
empancar	pejar
inteligência	mente
entortadura	torço
agrinaldar	festonar
ajudante	auxiliar
fragalheiro	molambudo
friso	quebra
longíquo	póstero
declive	pendor
chilreador	chilreiro
alucinar	desatinar
calmo	calmoso
manicurto	mesquinho
aprazer	deliciar
desfavorecer	renegar
etiqueta	praxe
aniquilamento	profusão
blasonador	bufador
absconder-se	ocultar-se
auferir	ter
regueira	riacho
ancoradouro	fundeadoiro
arreata	reata
colorar	envolver
expressão	gesto
aboleimar	apalmar
aerobata	aeróbata
desmiudar	minudenciar
agrilhoar	engranzar
aderir	gostar
convencedor	suasório
chefiar	patroar
melodia	música
encher-se	estufar-se
tento	tino
amarrar-se	emperrar
inquérito	interrogação
pascer	retoiçar
animado	espigaitado
bestear	zanzar
insinuar	ministrar
dirigido	orientado
desbastecer	madurecer
falha	imperfeição
ferido	sentido
motejar	ridicularizar
arrancadura	surto
abrutamento	rudeza
alvinitente	flamíneo
repressor	repressório
aca	raposinho
provocante	sedutor
prosápia	rebolaria
cindir	desentrosar
administrado	encabeçado
adoçado	dulcificado
barulhar	estourar
armazém	mercearia
encenar	ostentar
atolar-se	envasar-se
oprimir	urgir
cinocefálico	cinocéfalo
desflorescer	murchecer
bruxedo	macumba
asteróide	estrelário
apalpar	farejar
bofetada	bofetão
embravecimento	encrespadura
arremedo	macaqueação
demandar	espreitar
escasso	minguado
côncavo	fundo
maravilhar	surpreender
cabrucar	roçar
bólido	zelação
barato	prosaico
aparte	interrupção
submisso	súdito
alegar	reportar
casquilhar-se	encasquilhar-se
denunciante	malsim
dormente	plácido
desempenado	destro
anacorético	lauretano
singrar	traspassar
anárquico	bagunçado
titilar	xeretear
acreditado	afiançado
entusiasmar	excitar
reconfortar	reconstituir
burundanga	embrulhada
entredizer	entrefalar
mordedura	trincada
difamar	enegrecer
desconsentir	destoar
ampliação	crescimento
sendeiro	sevandija
confrontar-se	encarar-se
apendoar	pendoar
profetizar	saber
campanulado	campanular
junta	par
encachaçar-se	encarrascar-se
vaguejar	zaranzar
sadio	salutar
amesquinhar	desatender
associar-se	consociar-se
advertir	repreender
palrear	revelar
gasalhar-se	recobrir-se
escarnido	mistificado
acendrar	defecar
beija-flor	colibri
assustado	titubante
gatunice	rapinagem
agradar-se	deleitar-se
acrisolar	madurar
coatar	reprimir
decifrar	decriptar
esgotamento	esgoto
empulhação	tapeação
birrento	embirrento
atrevido	audaz
desparecer	ruir
magnitude	pujança
gomoso	viscoso
atapetar	carpetar
chanfradura	entalhadura
gorar	naufragar
fulgir	tremer
acanhar	avergonhar
cheiro	rabeira
fofo	mole
pictórico	pitoresco
manivelar	ocupar-se
exultar	iluminar-se
estupidificar	materializar
errar	perambular
apalpação	tateamento
biliardário	multimilionário
erotização	sensualização
assenso	deferimento
auxílio	fortificação
entalha	talha
amolgar-se	cair
prolongação	prolongamento
estupendo	maravilhoso
assembléia	tertúlia
lambidela	lambuja
abafação	ocultação
alvanéu	alvenel
afoguear	ruborizar
quimbembes	xurumbambos
acobardar	atemorizar
confortador	confortante
álacre	influído
emissão	expedição
lucivéu	pára-luz
remediar	sanar
incontroversível	inquestionável
desonestidade	doblez
acômodo	favorável
perspirar	vislumbrar
preguicento	zorreiro
afrouxelado	delicado
desbrochar	germinar
acovardado	atemorado
enraivar	indignar
antiquado	antiquário
comovente	enternecedor
montear	superpor
ensoalheirado	ensolarado
revolver	voltar
vozeada	vozeio
escondedoiro	esconderijo
obcecar	obumbrar
luzimento	refulgência
pendor	rampa
equilibrar-se	ter-se
endurecer-se	petrificar-se
descida	queda
aferidor	afilador
descometer	desculpar
entregar	sacrificar
cruel	maldito
isofônico	isófono
rimar	versar
provocatório	reptador
adstringente	adstringitivo
chanfro	talha
lastrar	semear
gonzo	missagra
coar	destilar
ímpio	sacrílego
retumbar	toar
ilaquear	iludir
aurífico	dourado
colidir	percutir
milenarista	quiliasta
orla	tira
frente	rosto
educar	polir
quindim	tagaté
recatado	refletivo
andarilhar	vagabundear
prazer	satisfação
engenhar	inventar
estriado	zebrado
promover	suscitar
cauteloso	providente
abobarrado	tarouco
comedir	sopitar
avolumar	inflar
girar	mercanciar
afagueiro	festeiro
formalizado	melindrado
ouropel	pechisbeque
desbaste	desmouta
estripar	eviscerar
atraiçoar	malsinar
compaixão	misericórdia
desparzir	radiar
esfarrapado	mal-entrajado
declarador	declarante
inchar	pavonear
encobardar-se	intimidar-se
despego	distanciamento
magricela	magriz
cobertura	tapação
cuspidela	cuspinhada
aparvoar	zonzar
ladeirame	ladeiramento
molestar	obsidiar
rama	ramalheira
regalia	vantagem
manobra	truque
bizarro	longânime
suelto	vária
laticinoso	leitoso
pertucho	portucho
altivo	campanudo
descauteloso	desprecatado
arrepelação	ulo
avermelhado	vermelhusco
averiguar	buscar
dependura	pendura
afetividade	querência
enlanguescido	prostrado
dilatado	grande
graceta	picuetada
cochicho	rumor
estagnar	imotar
hemicíclico	semicircular
antipatizar	implicar
aclimar-se	habituar-se
andaina	fileira
afagar-se	apascentar-se
tijucal	tujuco
agaiatado	malicioso
jorrar	manar
apavorado	despavorido
desprender-se	soltar-se
delicado	suave
defectivo	defeituoso
largada	sal
nativo	pátrio
esgravatar	palitar
admirar-se	mirar-se
anortear	guiar
brumado	brumoso
choradeira	gemido
ojerizar	peguinhar
delito	irregularidade
desabar	implodir
bem-ditoso	fortunoso
cabido	pertinente
golpear	torturar
acafelar	mentir
despedir-se	retirar-se
árduo	penoso
finura	sutileza
encarreirar	enveredar
desinteligência	divórcio
derreter	desvaecer
lesma	molenga
paramentar	vestir
centelha	faísca
doestar	escoicinhar
nuvioso	obumbrado
abarbar-se	aplainar-se
adelgar-se	afilar-se
despegar	estremar
patentear	revelar
cáften	rufião
aquentamento	esquentação
esfaqueador	esfaqueante
adestrado	industriado
encasquetar	induzir
engelhar	plicar
abandar	apartar
espavorizar	transir
oleoso	untuoso
apavesar-se	envaidar-se
adstritório	estíptico
dispensar	prescindir
indagar	procurar
hidrosfera	talassosfera
fruir	ter
encontrar-se	topar-se
escravizar	tiranizar
afagoso	amimador
delirar	doudejar
alfageme	espadeiro
sarro	sedimento
desagravo	melhora
chilique	fricote
letificar	medrar
desacanhar	desencabular
enervar-se	estiolar-se
chafurda	enxurdeiro
planalto	rechão
crispação	franzimento
diluvioso	torrentoso
arriar	desesperar
encravelhar	enrabichar
esbanjamento	prodigalização
encaixar	introduzir
escoriar	limpar
crespir	salpicar
cincada	erro
amarrotado	enrugado
penado	sofredor
capeado	encoberto
contrabando	muamba
cilada	esparrela
ozonado	ozonizado
rosear	tauxiar
dozena	dúzia
afeminado	amulherengado
enroscar	estreitar
enlamear	manchar
abastecido	aparelhado
refletido	sisudo
desconfiança	mesquinhez
conseqüência	fruto
folheação	foliação
despacho	envio
aparecimento	eclosão
conseguir	ter
pressentir	profetar
babaquara	piraquara
bruxa	feiticeira
massacrar	modornar
enredo	matéria
cientificar-se	noticiar-se
isolar-se	retrair-se
rumorar	surdinar
acarretar	produzir
empenhorar	obrigar
cultivo	cultura
interpor	intrometer
brigante	conflituoso
elator	erector
estugar	provocar
embargamento	emperramento
orientação	rota
congregar	ligar
derriçar	facetear
firmar	prender
mariola	maroto
favorito	preferido
indicação	indigitamento
ab-rogar	esfazer
desajeitado	inhenho
guardado	vigiado
consócio	parceiro
desconcertado	embaraçado
astúcia	subtileza
desconvizinho	desviado
caroneado	deluso
precinto	zona
tentame	tentativa
bifurcar	derivar
exagerar	rebuscar
enrubescer	esfoguear
compelir	obrigar
lusitanofílico	lusofílico
espavorecer	estarrecer
ferrado	recalcitrante
doidaria	maluquice
caçambeiro	lisonjeador
deduzir	inferir
procela	tormenta
adoçamento	adocicamento
arrasar	carregar
descoberto	flagrante
assuada	balbúrdia
furtar	rapinhar
bem-composto	bem-vestido
chã	planície
desumanidade	malevolência
raia	risca
remoçante	remoçativo
epítome	súmula
pé-de-meia	reservas
falcatrua	marotagem
estalar	saltar
badameco	pequenote
mágico	vatídico
debater-se	estrebuchar-se
cotovelar	esfoguear
irreflexivo	irreflexo
auto-estima	auto-respeito
balsâmico	perfumoso
homizio	valhacoito
destemeroso	impertérrito
alcatruzado	combo
arqueamento	dobramento
alba	albor
arrojar-se	atrever-se
desmandado	intemperante
nateirado	natento
inube	límpido
mesquinheza	minimidade
conspiração	conspirata
apostolizador	evangelizador
agachar-se	encafuar-se
destro	lesto
benéfico	bondoseiro
acetificar-se	vinagrar-se
rompimento	suspensão
cardinal	principal
embeiçar	enfeitiçar
excogitar	pensar
insulamento	penumbra
declarar	escolher
azebrado	azinabrado
golpe	pancada
furibundo	irado
chicotar	surrar
expressar	exprimir
adaptar	preparar
rachar	tundar
flexível	maleável
comprimir	retrair
redimir	reembolsar
purgar-se	reabilitar-se
desempossar	despojar
arrefeçado	desentonado
menospreçar	pospor
eufônico	melodioso
redondeza	rotundidade
algodoaria	cotonifício
benigno	indulgente
alvar	tolo
mediador	medianeiro
amargar	provar
diamba	dirijo
ambigüidade	equivocidade
contornar	quebrar
esmeraldear	esverdear
apelidar	titular
encarrilar	encarrilhar
tabernal	tavernário
botocudo	rústico
cúmplice	sócio
maconha	pango
bochornal	calmo
mefítico	pestilencial
hospitalar	nosocômico
esfomeado	esganado
ir	perecer
desencoscorar	deslisar
reptador	reptante
colérico	sanhudo
robusteza	saúde
corrosão	desgaste
endosse	ratificação
contemplar-se	ver-se
mímico	pantomimeiro
barganhado	permutado
francamente	lealmente
aventureiro	perigoso
aparvado	apatetado
incrementar	ornamentar
petume	tabaco
instrumentista	músico
guita	negalho
zoina	zonzo
apagamento	expunção
esmagar	inquerir
depurar	purificar
idear	inventar
apavonado	vanglorioso
pérfido	traiçoeiro
embestar	fincar-se
afobado	azafamado
sobreagudo	superagudo
mortificar-se	penalizar-se
conversão	transmudação
abrutado	abrutalhado
reles	sórdido
enraivecido	iracundo
dormência	letargo
desconjuntar	recalcar
esfarinhar-se	migar-se
palavrório	parlenda
dom	habilidade
inutilizar	malograr
afracado	anemiado
amoldurar-se	espenicar-se
coloidal	colóide
boquear	vasquear
desacumular	queimar
prestativo	solícito
ajaezar	vestir
despavorir	espantar
aclarar-se	alumbrar-se
robissão	sutambaque
pleiteante	pleitista
capcioso	sabido
martirizar-se	remoer-se
abnegar	renunciar
acavalar	superpor
rumorejar	surdinar
entremesclar-se	misturar-se
guapo	temido
remeter-se	reportar-se
turbar-se	velar-se
chorumela	frioleira
beliscado	incitado
descuido	despercebimento
feição	pinta
apropositado	pertinente
irrequieto	pressuroso
cenagoso	obsceno
amasso	esfregamento
argileira	barreiro
acrimônia	agro
inusitado	inusual
ababelado	desarrumado
descompostura	zagunchada
apodar	debicar
improvável	incerto
espera	expectação
confiado	desenvergonhado
frescor	viveza
bambaleio	bamboleadura
caiporice	caiporismo
gozo	usufruto
charruar	navegar
ferroar	repreender
desintegração	separação
fenecido	torrado
conspicuidade	notabilidade
castigar	ensinar
discutir	disputar
forjar	mascavar
astilha	estila
acirrado	exacerbado
enfadar-se	nausear-se
profligação	retrocesso
ânsia	engulho
defeito	vício
colidente	desencontrado
jubilar	recrear
estrepitoso	soberbo
intrépido	temerário
aninhar	encafurnar
armadilha	espera
enfunar-se	orgulhar-se
ressecar	ressequir
adumbrar	debuxar
hominiano	homínido
enferrujado	ferrugento
caçoador	sarcástico
ocupar-se	rasar-se
adiado	retardado
atraidor	fascinador
adstrito	restrito
simiano	simiesco
descorar	empalidecer
deslocar-se	despreender-se
pateta	patola
relinchar	trinir
acastelar-se	acumular-se
renunciar	resignar
diretor	gestor
gabação	ufania
enxergar	perceber
medir	proporcionar
chamado	convocatória
desalentar	desanimar
embustice	engano
abatedoiro	abatedouro
fertilidade	riqueza
grecolátrico	helenolátrico
flauteio	trote
deformar	desfigurar
indiferenciação	indiscriminação
implicar	ter
desfiguração	malformação
guloso	lambeiro
bruxulear	estrelar
belver	miradoiro
intumescimento	turgência
porrete	trocho
confessar-se	reconhecer-se
absconder	encafuar
esvoejar	voltejar
irritador	irritativo
desnortear-se	estremunhar-se
ardileza	raposia
dissenso	divergência
compassar	ritmar
projeção	saliência
explicar	instituir
clandestinidade	ilegitimidade
esbandalhar	estrinçar
desaguar	esvaziar
fosquinha	trejeito
incorrer	tropeçar
acarinhamento	quindim
recurso	socorro
ebulitivo	fervente
baixio	parcel
consagrar	sacramentar
enrijar	revigorar
cativar-se	subjugar-se
flatulência	gases
aparecer	sair
desengenhoso	imbecil
gaiola	prisão
predição	prognosticação
lampadejar	lucilar
contrastear	esmar
amergulhar-se	amodornar-se
restos	sarandalhos
escarnir	trotear
palúdico	paludoso
inane	nugativo
desafeito	desvezado
engrimponar-se	estadear-se
persecução	perseguição
empedrouçado	pedregoso
frouxo	mole
friagem	frialdade
embelezar	inebriar
médio	meio
cadencioso	melodioso
amortificar	temperar
alegado	referido
cambembe	estavanado
fineza	penetração
figurado	metafórico
saquear	tomar
força	robustidão
chalrador	gralhador
estalador	estralante
diz-que-diz-que	voz
ameno	moderado
predicação	sermão
berloque	pendericalho
isolado	solitário
arrunhar	lacerar
amoldurar	sazonar
figura	ilustração
bonacheirão	bonacheiro
comparar	opor
esboroamento	rebentação
indagação	inquérito
escólio	nota
corrente	veia
desembocar-se	despejar-se
desmedroso	ousado
dizer	ferir
aplanar	desentaipar
potência	robustidão
barral	barreira
evaporar	liberar
possessor	possuidor
ensinar	indicar
afinidade	intimidade
bodoso	embodegado
encafuar-se	ocultar-se
agourento	ominoso
granir	pontilhar
subir	valorar
manuseação	manuseamento
dadivoso	generoso
amador	amante
enlinhar	perturbar
amelindrado	ressentido
excreção	expulsão
corrompimento	podriqueira
altercador	altercante
madraço	zopeiro
acuidade	fineza
liceal	liceano
anafado	luzidio
luniforme	lunulado
conectivo	copulativo
casar-se	unir-se
estirado	tenso
dilacerar-se	moer-se
combinar	consonar
deparar	desencobrir
burlão	intrujão
inumano	truculento
impressionador	impressionante
atroada	bulha
invectivo	ofensivo
encrespar-se	franzir-se
persuasivo	suasório
danificar	daninhar
cretinice	zotismo
imaginador	imaginante
prestável	servível
buscar	pegar-se
desdobrar-se	escangalhar-se
alarmado	intranqüilo
tascar	trincar
munhecaço	tabefe
acurvamento	derreamento
contenda	renhimento
recomeçar	voltar
digladiar	triscar
astral	ástreo
cilindróide	teretiforme
patriarcal	venerável
afoito	longânime
afinamento	perfeição
pipilar	regorjear
claramente	obviamente
descomunal	desmensurável
abonado	ourudo
atochado	comprimido
fétido	putrefeito
angüiforme	serpentinado
coalhado	repleto
esborro	vertedura
baralhamento	permistão
labrego	lapuz
à-toa	imponderado
apaixonar-se	embeiçar-se
pendente	penduricalho
azougar	preocupar
apocalítico	informe
garantir-se	precautelar-se
fornecer	produzir
encompridar	espichar
pivô	promotor
modulado	musical
bagana	bituca
ferrabrás	mata-mouros
desafrontar	desapertar
gerência	gestão
afoutar-se	enfeitar-se
adequar-se	arranjar-se
mutuar	permutar
molengo	pachola
apurpurar	vermelhar
derrota	desbarate
transferir-se	transladar-se
alcançado	atingido
anilado	azulado
desatento	distraído
reduzir	sujeitar
ondar	ondear
achegar-se	chegar-se
alterado	desinquieto
agressão	ripada
contraverter	soçobrar
aparamentar-se	espenicar-se
desatinar	desencarrilar
encorujado	jaruru
altiloqüência	sublimidade
bueiro	sumidoiro
honorabilidade	mérito
meigamente	mimosamente
dentado	mordido
encrassar	inspissar
demora	retardamento
desvirtuação	envilecimento
aguilhão	atiçamento
embotar	enfraquecer
deturbar	intranqüilizar
galanar	janotear
atenuação	refrescamento
cometer	interprender
peloso	peludo
parolar	tarelar
regatear	vilificar
indiscernimento	indiscriminação
benemerência	mérito
despontar	raiar
encruecer-se	escabritar-se
desquietar	exagitar
roubo	trapaça
madeixa	mecha
desvelar	elucidar
colisão	dissidência
oval	ovalar
encontro	obstáculo
canção	cantadela
inumanidade	sanguinolência
circunspecção	tino
aterrar	poisar
amontoamento	sobreposição
alcançamento	obtenção
eqüitativo	íntegro
espalhar-se	semear
garrear	tomar
camada	classe
acalmado	aplacado
cheia	undação
abonativo	abonável
desfaçado	impudico
agrimônia	agrura
acerar	azerar
alcatroar	empezar
antologia	seleção
espumante	furente
reatiçar	reespertar
contorno	volta
faroleiro	lanterneiro
acume	máximo
jactanciar-se	louvar-se
formalizar-se	melindrar-se
fulgentear	fulgir
apavonar	ufanar
frenético	impaciente
tenebroso	tremendo
elogiado	louvado
adoba	adobe
reciprocar-se	revezar-se
horrorífico	horroroso
arranjar-se	avir-se
desencaminhar	extraviar
confrontar	encontrar
biqueira	goteira
desimanado	desmagnetizado
gotear	transudar
aréola	resplandor
escoadura	escorrência
beatice	beatismo
sessar	sururucar
calúnia	mentira
bailado	dança
garrido	pimpão
aíva	chué
liso	macio
calma	repouso
afligimento	agonia
inebriado	tonto
desacobardar	esforçar
maleta	malote
pícaro	solerte
cadenciado	rítmico
inferioridade	pequenez
quinta	rancho
andejo	errático
operativo	produtivo
destroncar	truncar
esclarecido	explicado
considerável	notável
frender	irritar-se
crença	fé
calcular	medir
algemar-se	atar-se
desvitalizado	quebrantado
avarento	avaro
expiação	purificação
atrabiliário	tomadiço
autenticidade	lidimidade
distrate	distrato
desarrumar	desestruturar
esvazar	verter
insensatez	loucura
abasbacar	trepidar
derruimento	desmoronamento
endestésico	endestético
embusteirice	trapaça
avelhado	avelhantado
esperança	pensamento
avantajado	grande
medusa	xaveco
acanelar	estriar
obscuro	trevoso
favor	graça
embalar	embelecar
prostituir	rebaixar
abrandamento	acalmação
amulatar-se	bronzear-se
mirrado	torrado
cenário	cenatório
aconchavar-se	aparceirar-se
condoreiro	rebuscado
anafrodisia	impotência
aprear	confinar
afoitar	estimular
pertinácia	recalcitração
devorante	lambaz
azucrinar	irritar
desformar	transmudar
espanholada	fanfarronice
esquiva	evasão
bajulador	zumbaieiro
vaziar	verter
catadupa	salto
derrubada	devastação
desnivelar	discernir
coacervado	encastelado
ar	tom
azedo	fermentado
dardada	lancetada
enclausurar-se	recolher-se
emaranhamento	embaraçamento
empecilho	tropecilho
goteira	quelha
absterso	purificado
caloiro	recruta
atentar	desafiar
esfuziar	vagalumear
alberca	aquário
enverdecer-se	reverdecer-se
calcar	encarregar
reflorescer	renascer
graça	pico
contrariedade	oposição
babão	palonço
capinar	roçar
menosprezar	sobpor
borraceiro	borriço
encarrapitar-se	engrimpar-se
esburaquento	furado
madracear	suciar
coincidir	haver
basilar	essencial
concernir	convir
arriosca	ludíbrio
reflexivo	sensato
almiscarado	cheiroso
poitar	puitar
desordenar-se	perder-se
ababadar	arrepanhar
derrengar-se	esbamboar-se
rapidez	velocidade
desgastar	devorar
flamíneo	nítido
embravear	embravecer
chicotear	lambar
amulherado	inviril
afanado	fatigado
piar	pipilar
morrão	pevide
pandeireiro	pandeirista
raposeira	soneca
proeminência	relevo
excitação	inquietação
acarrear	suscitar
iterar	voltar
aplacação	contemporização
debochar-se	desvirtuar-se
flatuloso	flatuoso
abobalhar-se	apatetar-se
emasculação	mutilação
ebriático	embriagante
encruzar	transpor
ensacar	entroixar
grisisco	ruço
carcarejar	matraquear
arrancar	sufocar
septênio	setênio
falecimento	finamento
principesco	soberbo
parte	pedaço
acalorado	esfogueado
esconso	reconditório
raspe	repreensão
mama	teta
denunciar-se	descobrir-se
prover	refazer
pegajoso	tenaz
encovar	subterrar
barafunda	desordem
destroncado	luxado
abstrair	afastar
empurrar	socar
entibiar	extenuar
eternizar-se	perpetuar-se
retratação	retrato
derraigado	desarraigado
ardido	arrojado
juramento	promessa
insito	natural
respeitoso	reverente
contínuo	freqüente
charro	grosseiro
repanhar	tomar
participador	partícipe
lamborada	lategada
dévio	difícil
enfastiante	maçante
escoicinhador	escouceador
embaçadeiro	embaçador
alvoroçar-se	pronunciar-se
escondido	escuso
esbanjador	estróina
apuamento	penitência
espécie	laia
sobredourar	sublimar
magistral	perfeito
fumar	tabaquear
desentortar	reparar
desenvencilhado	desenvincilhado
desarvorar	zonzar
cordato	sensato
atividade	dinamismo
fiada	rosário
encintar	enlaçar
enfuscar	obumbrar
encostar-se	esfregar-se
esmorecer	esvaecer
algemar	obrigar
debruçar	desaprumar
cuca	jabiraca
abaixar-se	aplainar-se
censual	censuário
esconderijo	rincão
escusado	supérfluo
eferente	exódico
conculcado	humilhado
bem	felicidade
furreca	ridículo
denegrido	enegrecido
azedado	exacerbado
constranger	oprimir
abreviação	encurtamento
acareador	acareante
antologiar	respigar
bebedor	cachaceiro
aviltar	humlhar
acentuar	pronunciar
uivar	uivo
corar	erubescer
indústria	trabalho
amenizar-se	aplacar-se
especar	estacar
troixa	zângano
sobrar	sobreabundar
enoitecer	toldar
servir-se	usar
aparição	fantasmagoria
encastelar-se	escudar-se
avantajar-se	galrar
desafeto	infenso
imobilidade	impraticabilidade
coalescer	juntar
balordo	manco
mentira	xodó
formando	graduando
igual	liso
disparar-se	esbandalhar-se
diminuto	manino
intrujão	trampolineiro
arrepelador	arrepelante
inclinação	proclividade
ladear	rodear
animar	bafejar
chamada	ligação
branquear	embranquecer
adocicar	dulcificar
fermentar	preocupar
omnissapiente	oníscio
decepção	desengano
ciumada	ciumaria
propina	xixica
dissolver	fundir
contrariável	controvertível
garotada	molecada
abacto	abigeato
delicioso	saboroso
abrasar	dissipar
amolar-se	entediar-se
paziguar	sedar
paga	remuneração
excerto	extrato
cachaço	toitiço
influência	jurisdição
aluar-se	alucinar-se
círculo	roda
debater	gladiar
leve	ligeiro
servil	subserviente
assentar-se	sedimentar-se
derretedura	liqüidificação
maçar-se	nausear-se
ambicioso	cúpido
arquitetado	edificado
emendar	escarmentar
bulhão	rixador
aljofrar	arrociar
aversão	enjôo
rebate	sentimento
assanhamento	atiramento
aglomerar	lotar
capitular	conceituar
infante	menineiro
vaporável	vaporizável
complicar-se	embretar-se
enlapado	refugiado
livrar-se	pisgar-se
açaimo	açamo
cumprir-se	dar-se
encobrado	enriquecido
desconcertador	desnorteador
abstraído	abstrato
incontestável	incontrovertível
diabólico	luciférico
anarquizado	bagunçado
encorrilhar	encoscorar
arranhar	raspar
esfacelar	esfrangalhar
entretecer	obrar
abundante	farto
enflorear	ornamentar
argumento	contexto
renovar	reverdecer
envigorar	vigorar
brutalizar-se	descivilizar-se
afeiçoamento	querença
espertar	sacudir
deslembrado	olvidado
tapeçar	tapizar
ceifar	fouçar
materializar-se	objetivar-se
inadequado	inapropriado
escampar	evadir
complicado	enredado
desconexão	inconexão
assimilar	entender
repercutir	ressoar
abraçar	juntar
isolar	separar
antecedente	anterior
gorjeado	trilado
aniquilação	eliminação
dispersado	espalhado
desenervar	vitalizar
componente	ingrediente
amorfanhar	encouchar
descongelação	descongelamento
ramelento	remelento
aformosear-se	engalanar-se
abarcamento	abrangência
mealha	ninharia
terrorar	terrorizar
desmoralização	profanação
importar	introduzir
almargeal	pasto
falacioso	tunador
expirar	patentizar
desabusado	desfaçatoso
descasado	desemparelhado
corrimaca	porção
fugitivo	transitivo
essencialidade	necessidade
entreaberto	soaberto
criatividade	inventiva
contato	convívio
acordo	conformidade
relampear	relampejar
conato	insito
cabo	extremidade
afeição	predileção
amazelado	deselegante
perturbar	torvar
adágio	provérbio
boleta	penduricalho
descendência	renovo
assombro	temor
pertinaz	porfiado
abainhar	embainhar
desapego	despego
acastoado	encastoado
encerrado	incluso
obsequiador	solícito
afligido	atritado
condenação	sentença
bezerra	novilha
embaciar	ençampar
alerta	atentamente
aprisco	ovil
acético	acre
inconfidente	insidioso
desbastar	limar
betumar	betuminizar
expatriado	êxule
afetuoso	maternal
amordaçar	emordaçar
dominar	reprimir
magoar-se	sentir-se
analgésico	análgico
demudar-se	transmudar-se
churdo	ludroso
arrenego	renunciação
putrefato	putrefeito
atrincheirar	envalar
toada	tono
embrutar	estupidificar
encafurnar	enlocar
fibra	força
imoral	obsceno
banir	desconjurar
enfadoso	peto
pactuar	temporizar
espetaculoso	luxuoso
aguaritar	albergar
aferrar-se	empeiticar
mercanciar	negociar
remador	rêmige
adiantar	antecipar
justificativa	satisfação
derribar	desentronizar
enchafurdar	subverter-se
arrugado	enrugado
viger	vigorar
devastar	infestar
acafelamento	reboco
encarar	topar
televisão	tevê
aliar	conjungir
cacaréus	caraminguás
besta	rombo
atesar	endurar
desalmo	violento
italianomaníaco	italômano
defensão	resguardo
afiliação	associação
remição	salvação
esbordoar	rachar
enlanguescente	languescente
empapado	repassado
narrado	referido
tranca	tranqueta
assaltear	tomar
muxirão	muxirum
natural	originário
sapeca	trêfego
empertigado	ereto
ganhar	reconvir
insistência	permanência
lenitivo	refrigério
cartada	lanço
excelente	perfeito
luz	resplendência
rebelado	revoltado
testeira	vanguarda
espalhafatoso	mirabolante
parvoeirar	parvoejar
apejar	vedar
antagonista	concorrente
sobrestima	superestimação
sugestionador	sugestionante
miséria	sovinice
fabricar	imaginar
derriscar	tirar
incômodo	molestoso
benevolência	bondade
carícia	quitute
resvaladiço	resvaladouro
inferior	subalterno
enrinconar	rinconar
cara	queixo
aplaudido	laureado
desenvencilhar-se	despegar-se
genuíno	particular
apologizar	desculpar
dejungir	engaiolar
arriscado	venturoso
amado	querido
clamor	vindicação
tabernáculo	tenda
crestar-se	tostar-se
aclimatável	aclimável
larapiar	subtrair
conquistar	tomar
banha	chorume
planificação	programação
encardir	encarvoejar
abarbarado	corajoso
obscurecer-se	perder-se
cobrar	refocilar
admirabilidade	genialidade
coagir	reduzir
adargar-se	velar-se
blindado	encouraçado
entecer	entretecer
tecido	teia
tragadouro	voragem
projetar	propulsar
chavasquice	impolidez
entravar	pausar
aburacar	broquear
batumado	encrespado
associado	emparceirado
enfraquentar	enlanguescer
malposto	malvestido
descomedir-se	desenfrenar-se
exasperar-se	irritar-se
baratear	envilecer
sobejos	varredura
czar	tzar
indisciplinabilidade	rebeldia
engambelar	engrambelar
consorciar-se	desposar
ripa	sarrafo
afloramento	aplainamento
casca	côdea
graxo	untuoso
reflorir	renascer
acessório	detalhe
fenecer	prontificar
ensaboar	recriminar
conter-se	subjugar-se
adolescer	gradar
esclarecer	interpretar
bambolear-se	requebrar-se
rebusca	rebusco
frioleira	palha
coceira	uredo
desimpedir	safar
pináculo	zingamocho
irresolução	perplexidez
vapular	zurzir
banhar	embeber
prolongar-se	prorrogar-se
apavorar-se	intimidar-se
intrometidiço	xereta
escrutável	perscrutável
faiscante	tremeluzente
copioso	opulento
deforme	monstruoso
enliçar	fraudar
puxão	puxavante
perambulagem	vadiagem
embasbacar-se	surpreender-se
culto	policiado
sangue	vida
bastardear	degenerar
confrontação	contraposição
desbarretar-se	descobrir-se
achincalhamento	escárnio
perseverança	persistência
doneador	galanteador
assoberbado	imponente
efêmero	transitivo
desencalmar	desenraivecer
suro	torado
enrugado	rugado
profanar	trespassar
moslém	moslim
debilitado	prostrado
conceituação	definição
papa-fina	saboroso
incontrastável	irrefragável
abaçanar	desdourar
abalsar	embalçar
tabela	tabilha
preceituar	prescrever
calçadeira	descalçador
abuzinado	afunilado
agarrar-se	filar-se
epilogar	trancar
embriagar	inebriar
assedentado	sequioso
atualidade	dia
desobrigado	isento
desfigurado	transformado
considerar	encarar
infértil	infrutífero
atrapalhar	perturbar
escavacar	estroçar
boto	cego
galanteio	xodó
caranguejar	embasbacar
enlevo	êxtase
divertir-se	folgazar
compadecer	suportar
troante	trovejante
deslumbre	fascínio
desgraçado	malfadado
agrícola	arvicultor
quitute	tagaté
ação	demanda
coarctação	estreitamento
carmim	carminado
apreciável	assinalável
aristocracia	nata
agrupar	integralizar
arrasado	devastado
espeque	estronca
readquirir	resgatar
criado	servente
ofensivo	prejudicial
abarcar	atinar
sugestionável	sugestível
machucar	vulnerar
escorregão	escorrego
errado	errôneo
regresso	retorno
ressair	ressaltar
hiperurbanismo	ultracorreção
agencioso	ativo
consumir-se	ir
cobiçado	desejado
madraçar	passarinhar
codificar	coligir
enfraquecido	enfraquentado
espacejar-se	estender-se
estorricado	ressequido
libertar	tirar
mistela	mistifório
feroz	sanguinolento
encruzilhar	rasgar
dilatório	moratório
desocupado	vago
intrometer-se	meter-se
sestro	sorte
desigualar-se	desnivelar-se
arrepanhado	encascorado
incorrutível	reto
petema	pitura
dignificação	nobilitação
volitar	voltear
fuçar	xeretar
entrebranco	exalviçado
abastadear	desdizer
espirro	esternutação
faltar	tropeçar
horrífero	torvo
curvar-se	envergar-se
artesão	artista
donairosamente	galhardamente
acanavear-se	emagrecer-se
mútilo	seccionado
pirueta	reviravolta
bizarrismo	extravagância
concorrente	oponente
plebeu	ruão
hilariar	hilarizar
malaxar	matar
globosidade	rotundidade
barrela	coada
esbofamento	exaustão
cegante	deslumbroso
adquisição	alcance
xingação	xingo
cravejar	embutir
jirau	sobreloja
arrancada	egressão
indício	toque
arrociar	relentar
malconformado	malproporcionado
assoalhar	dar
empresa	pressuposto
cuidar	imaginar
agrumelar	encaramelar
convergência	influxo
enrijecer	revigorar
emaçarocado	emaranhado
falhado	fissurado
betar	marchetar
fecundar	vivificar
amanhar	lavrar
ensoberbecer-se	intumescer-se
imperturbável	inalterável
embair	embalar
labutar	trabalhar
alhanar	alivelar
abatocar	tapar
celebrar	exalçar
virar	voltar
grudento	tenaz
jogada	lance
contingente	transitório
espinhar-se	fumar
mitene	punhete
encetadura	inauguração
remordaz	remordente
interceptado	intercepto
desafamar	setear
estrebuchar-se	remexer-se
faraônico	luxuoso
alegrar-se	congratular-se
conflagração	revolta
esferal	esférico
desacato	desveneração
ferrar	travar
choça	mocambo
aposentado	inativo
aglomerar-se	associar-se
escapulir	evitar
convizinho	parecido
infernizar	quizilar
avernal	infernal
crucial	precípuo
ápice	topo
arrastar	pregar
dissipador	malgovernado
brutalmente	brutamente
refreamento	repressão
censurar	estranhar
dedicar	devotar
ocioso	ronceiro
engonço	gonzo
distanciar-se	distar
esquivar	remediar
recidivo	reincidente
custoso	duro
doar	sacrificar
estomagar-se	torvar-se
retoque	revisão
infeccionado	infectado
abandalhar-se	aviltar-se
esfregação	esfregadura
danado	exasperado
antiquar	desatualizar
indigência	penúria
incorporar	reunir
incumbir	recomendar
excecionalidade	originalidade
inato	natural
desimpedimento	desobstruência
ardor	brasa
instituir	nomear
babugeira	sarambelada
aperfeiçoamento	aprimoramento
desditado	infortunado
mecha	pavio
afrontado	ofendido
pausar	remorar
evasivo	sutil
resto	sobra
cotidianidade	unissonância
animação	vibração
inupto	solteiro
ababadar-se	repanhar-se
concúbito	cópula
fanfarronar	pespontar
transbordante	trasbordante
quietismo	requietude
desarranjado	descuidado
enroxado	enroxecido
tropeçar	vacilar
asnidade	bestice
gladiar	questionar
formosentar	tecer
avelhentado	malconservado
honestizar	nobilitar
extrapassar	sobreexceder
cachorrice	cafajestice
agenciador	laborioso
adicionar	enxertar
demover	despersuadir
acoimado	castigado
beberar	infiltrar
confinante	contérmino
matina	matinada
aberrativo	anômalo
ordenar	regularizar
exorar	pedir
acuminar	amolar
hesitante	titubante
lançar-se	saltar
ensementar	estender
oculto	sobrenatural
enevoado	turvo
apelidado	denominado
fulminar	resplandecer
enregelar	gelar
despegar-se	saltar
estalido	traque
debilidade	senilidade
receita	rendimento
introdução	preliminar
delator	malsim
alcoolizar-se	melar-se
emporcalhamento	enlameadura
completo	ultimado
bucólico	campeiro
malversador	malversor
antojar	imaginar
esquecido	preterido
abjuração	abrenunciação
caça	perseguição
quebra	quebrantamento
caducidade	decrepitude
baboseira	bajoujice
recém-nado	recém-nascido
desvincilhar	estriçar
airado	resfriado
ressaibo	testemunho
acostumar-se	costumar-se
descobrir	mostrar
punição	vara
precavido	prudente
batalhador	pelejador
carruagem	diligência
explodir	expluir
pedido	súplica
firmar-se	fundar-se
veracidade	veridicidade
ministrar	soprar
desarmar-se	sensibilizar-se
ditado	rifão
buzinada	cornetada
rubor	vermelhão
arrombar	quebrar
escojuração	jura
corresponder	satisfazer
estiraçar	repuxar
esmerar	esmerar-se
ressentimento	tristeza
afobar	maranhar
pertinente	referente
dessossegar	remexer
sulcar	transpor
descobrir-se	transluzir-se
pastejar	retoiçar
enfarar	fartar
roborizar	vitalizar
mordida	mordidela
convalescença	restauração
apassionar-se	enamorar-se
espezinhar	sobrecarregar
esquadrinhar	procurar
contribuição	encargo
desarraigar	varrer
debochado	licencioso
contraditório	paradoxal
forcado	garfo
bizarrice	extravagância
fustigar	vergastar
limitativo	restringente
desanimado	desmoralizado
axial	axóide
encrencar-se	enredear-se
jazida	veio
preambular	proemiar
dândi	janota
dilúculo	entremanhã
espirituoso	facecioso
incontável	inumeroso
tresdobro	triplo
austero	prudente
grandiosidade	imponência
flâmeo	rebrilhoso
audácia	desembaraço
encravar-se	engastar-se
lamento	murmúrio
montar	situar
chorado	pranteado
afoitar-se	afoutar-se
cultivado	culto
estreiteza	penúria
dilucidar	enuclear
bruto	mazorro
diluir-se	resolver-se
executar	ocupar
ostensão	vaidade
encarniçar	provocar
treitento	velhaco
derrocamento	derrubamento
ociosidade	preguiça
archote	luzeiro
jatancioso	presumido
pagar-se	reparar-se
trigueiro	triguenho
azedar	estomagar
direcionar-se	encaminhar-se
concludente	terminativo
folhar	folhear
corrimento	escoamento
refrulho	rumorejo
suportar	tomar
curvado	curvo
pesa-papéis	peso
agasalhar-se	recobrir-se
desonrador	desonrante
espaçoso	grande
demudar	mudar
ameigado	apaparicado
corrupiar	rodopiar
descanhotar	recalcar
arqueadura	encurvamento
definido	divisado
certar	debater
atenciosamente	polidamente
noctâmbulo	sonâmbulo
escavar	esvaziar
sorrir	troçar
peça	pirraça
inconstante	volúvel
plaga	terra
estentóreo	estentoroso
chegado	íntimo
corar-se	encafifar-se
desatendido	indeferido
inexato	inveraz
fação	facção
reafirmação	sustentação
capital	mortal
malefício	prejuízo
encaixotar	encavar
liquidez	liqüidez
bacanal	libertinagem
arrevesado	nebuloso
gergelim	zirzelim
fresco	recente
copado	frondente
adjeto	conjunto
falseamento	malsinação
ablegar-se	desligar-se
azoratado	gira
arreganho	desassombro
chorar	ulular
atalho	senda
atristurado	mazorro
esfachear	lascar
arremetedura	arrojamento
encomenda	pedido
bucuva	tolaz
florear	floretear
ajavardar	descivilizar
ostensório	patente
escarmento	increpação
burlado	embaído
podridão	podriqueira
empurrão	encontrada
papagaio	quadrado
emoldar	formar
abicar	aguçar
dissentir	implicar
atabalhoado	enleado
aspergir	desparzir
emborcação	entornadura
colecionar	reunir
poluição	xila
exceder	preceder
desnaturar	deteriorar
hediondo	hórrido
lamber	tocar
aprovar	simpatizar
ditatorialismo	governismo
desgosto	enfado
administração	direção
assanhadiço	violento
endemoninhar	irar
resoluto	valente
cadivo	coroca
alvidramento	arbítrio
indócil	insubordinável
ourudo	pecunioso
sustento	vivenda
cético	descrente
disseminar	proclamar
melodiar	melodizar
largar-se	refugir
extorquir	roubar
faveiro	potoqueiro
desatravancamento	desimpedimento
fatível	fazível
frangível	rúptil
pulha	reles
discernimento	exame
desviar-se	escabecear
recobrir	resguardar
arear	estrovinhar-se
desculpar	ilibar
escalpelizar	rebater
bissociação	trocado
roscado	rosqueado
mal-arrumado	mal-enjorcado
arrodear	rondear
apeçonhado	venenoso
descorçoado	sucumbido
fenda	rachadela
cercar	toucar
derrotar	sobrepujar
aconselhamento	persuasão
acorçoar	aquecer
inserção	interposição
minúcia	pormenor
confessor	cura
encacho	tangueiro
caiar	emascarar
apavorante	aterrador
burburinho	murmurinho
cabeça	chefe
ineptidão	jericada
atempado	caído
depravador	perversor
denunciador	denunciante
santeiro	santério
xingamento	xingo
acréscimo	adicionamento
estragar-se	gastar-se
despojado	espoliado
obnubilar-se	obscurecer-se
jornada	viajada
campar	enrinconar
arrodelar-se	cobrir-se
esbórnia	pândega
arauto	internúncio
abolçar	rejeitar
propagar-se	transpirar
calda	xarope
macieza	moleza
esfazer-se	exalar-se
beberrote	cachaceiro
alicerçador	fundamentador
lugarejo	sítio
armar	maquinar
inscrever-se	matricular-se
enquadramento	inclusão
insigne	renomeado
patente	visível
bambalear	sacudir
galanteado	requestado
conjurar	impetrar
magriço	magrizela
dimanação	emanação
consolidar-se	louvar-se
florescer	vingar
vaporizar-se	volatizar-se
fagueiro	namorado
distração	espairecimento
bisbilho	múrmur
eloqüente	facundo
gotejar	transudar
adorador	fã
estrábico	vasqueiro
opinioso	porfioso
carnalidade	mundanalidade
decolorar	descorar
intumescência	turgescência
rimbombância	trovão
recaimento	reincidência
montanhês	montano
arengueiro	enredeiro
preâmbulo	prelúdio
brio	potra
cinta	precinto
desoneração	isenção
arremate	fecho
escasseado	falho
aplastar-se	cansar-se
descocado	impudente
apensar	apor
aviltado	depreciado
cerimonioso	mesurado
abaixamento	acaçapamento
abolsar-se	estufar-se
refulgência	rutilância
desencardir	limpar
descair	tombar
dispersar	estroçar
aquecido	encanzinado
calcadura	esmagamento
matutar	meditar
termo	túmulo
insinuar-se	presentar-se
motivar	ocasionar
magrete	magruço
replicar	retorqüir
afogueamento	caldeamento
aperiente	ecfrático
porejar	revir
atassalhar	retalhar
depilar	rapar
ajustamento	enquadramento
bradejar	uivar
antiibérico	antiiberista
atormentado	magoado
fúmeo	fúmido
deslizadeiro	resvaladoiro
ideal	idealização
pitada	ponta
benfeitoria	melhoramento
abugalhar	esgazear
indolência	madraçaria
discreto	judicioso
inocular	instilar
empuxar	impelir
despartir	desviar
enerve	lânguido
enfezar-se	importunar-se
mandrião	zopo
janotice	tafularia
concertar-se	dar-se
acrisolar-se	perfeiçoar-se
refinadura	refinamento
lodaçal	pântano
batelada	chorrilho
desinchação	detumescência
engalfinhar	pegar
agudez	subtilidade
desarar	descompor
embalado	iluso
escondedouro	esconso
liqüidante	liquidatário
espadeirada	estocada
contrário	desavindo
cortesão	esbelto
achar-se	encontrar-se
fardagem	roupagem
paganizador	paganizante
pestear	ulcerar
aventado	lembrado
prenunciação	prognóstico
abarreirar	ingurgitar
veda	vedação
depurador	mundificante
lançadura	remesso
birrar	encavacar
circuito	periferia
arrazoar	especular
rebater	sacudir
esgadelhado	esgrouviado
submeter	ter
iminência	sobrançaria
menear	sacolejar
butuca	espora
damejar	requestar
distante	saído
deitar-se	reclinar-se
machucar-se	susceptibilizar-se
lucrar	usufruir
atrabilioso	iracundo
sabrecar	torrefazer
diversório	prazer
parada	sustação
adscrever	algemar
esponjar	furtar
mistificar	velhacar
esterilizar	exaurir
ligeiro	veloz
cancelamento	rescisão
olorado	perfumoso
tessitura	traça
arremeter	opugnar
anulado	cassado
expandimento	extroversão
inditoso	infausto
escorregadio	liso
miúça	miuçalha
descompor	revirar
borrar	ensaburrar
brunhir	polimentar
mantear	nausear
malignar	subverter
inclinar-se	predispor-se
maça	toco
coalizão	coligação
decente	íntegro
endemoninhado	endiabrado
odoro	perfumado
avincar	dobrar
coerção	pressão
contraditar	opugnar
arisco	rebelde
apreciação	critério
chapar-se	estirar-se
inalterável	incorrutivo
reverter	tornar
flegma	traspasso
desnutrir	emagrecer
apostema	intumescência
inimigo	oposto
verberador	verberante
espirrar-se	estomagar-se
brotadura	gomo
mediocridade	regularidade
amochado	retraído
pervagar	vagar
efetuar-se	ocorrer
desasar	tungar
reclamar	vindicar
plausivelmente	racionalmente
casmurro	encaramujado
nonada	trica
inapropriado	inconveniente
aquilonar	setentrional
falho	lacunar
aturdido	estupefeito
brunir	polimentar
perder-se	soçobrar
trampolina	trampolinagem
forrar-se	roupar-se
alevante	levante
afligir	sorver
amiserar-se	mazelar-se
alimentício	substancial
minguado	precário
dreno	escoadoiro
magote	ranchada
torcilhão	torço
envanecer-se	inflar-se
entristecer-se	estiolar-se
enfrentar	entestar
arriscar-se	ousar
enraivado	enraivecido
desafronta	desopressão
deplorativo	lacrimante
inteireza	totalidade
esgarrar-se	viciar-se
remenicar	ripostar
somítico	sovina
aviltante	humilhante
acanalhado	amolecado
ininterruptamente	seguidamente
canhoto	desjeitoso
convencionar	estabelecer
objetivação	resolução
enfrenar-se	reprimir-se
descortejar	sobpor
afiançado	asseverado
coagido	invito
espectro	visagem
areado	desorientado
contra-atacar	responder
cobiçoso	sequioso
bonificar	laurear
demoníaco	diabólico
haver-se	portar-se
serviço	trabalho
solércia	sutilidade
espaçado	espacioso
berreiro	grita
valedoiro	valedouro
desempapar	desencharcar
abastecer	fornecer
farrear	fragalhotear
contestabilidade	repreensibilidade
doudejar	vagabundar
embramar	enroscar
achega	ajudadouro
apeado	dispensado
transmontano	ultramontano
enxovalhar-se	mediocrizar-se
engenho	inventividade
abster-se	coibir-se
anorgânico	inorgânico
pronto	rematado
reanimar	renovar
bravura	resolução
enxurdar-se	ingurgitar-se
integralmente	inteiramente
preciso	sintético
refundir	retificar
gargalo	pescoço
demolido	derruído
desaforo	protérvia
asfixiar-se	esganar-se
especificar	precisar
alteroso	assoberbado
elidir	suprimir
generosidade	gentileza
assoprado	campanudo
usança	vício
adjurar	invocar
lamuriar-se	prantear-se
mofatra	trapaça
balbuciar	tartamelear
vestido	vestuário
diminuir-se	ir
enxugadoiro	varal
torvelino	turbilhão
abnóxio	inofensivo
dispor-se	precaver-se
rezador	saludador
embarrigado	grávido
barganha	pechincha
encarrancar	enublar
aguaceiro	cordoada
olhar	saber
amurchecer	desflorescer
dobradura	vinco
enlaçar-se	prender-se
baralhada	rondão
atroante	tonitruante
amochar-se	enclausurar-se
edaz	insaciável
tutelar	tutorear
dietista	nutricionista
brandão	tocha
cruzar	passar
gralhear	tarelar
delirante	insano
chamamento	rebate
estertor	sarrido
bem-querer	estimar
adestrar	disciplinar
privilégio	vantagem
misericordioso	pio
encalistrar	tempestear
aldrava	argola
anichar-se	entrouxar-se
apelar	recorrer
burlar	tapear
engranzar	engrazar
encarquilhar-se	enrugar-se
desgraciado	infortunado
esvanecer-se	evolar-se
privativo	restrito
retorno	volta
assazonar-se	requintar-se
renitência	tineta
encadeamento	estruturação
arejo	refrescamento
postemar-se	torvar-se
despir	despossuir
maldito	triste
cântaro	talha
horrendo	tetro
coragem	valor
repousar	vacar
coscuvilheiro	enredeiro
lenda	mitologia
caveira	crânio
sandeu	tolaz
desagaloar	macular
colossalidade	enormidade
encarapitar-se	engrimponar-se
fraudento	fraudulento
cajadada	pancada
atinar	notar
desembrulhar	estriçar
despregar	separar
redutível	reduzível
endurar	obdurar
sonetar	sonetear
combater	punir
mesquinho	pelintra
fecundidade	uberdade
abarrancar	represar
abespinhar	encolerizar
caricato	cômico
contendedor	emulador
agitar-se	sacudir-se
atranqueirar	impedir
abater-se	inferiorizar-se
arreigado	crônico
semimorto	semivivo
advertir-se	atentar
embófia	presunção
construir	criar
endentação	engrenagem
cardinalesco	cardinalício
amontoado	poupado
demasiado	supervácuo
caipirice	jequice
engranzado	entrosado
babel	pandemônio
lobrigar	vislumbrar
prevenir-se	vigilar-se
avenado	azoratado
rebordosa	récipe
desnudo	despido
serelepe	turbulento
aluição	desabe
fanfarrada	farelice
fabrico	produto
proventos	vantagem
papo	saco
embaçar-se	enganar-se
manada	súcia
humanitário	humano
administrador	despenseiro
sobredivino	supradivino
pinga	pingo
transgredido	violado
extensão	força
agressividade	combatividade
falaz	mentido
gabarolice	orgulho
estanciar	habitar
mal-ensinado	mazorral
inflexo	pendido
contra-arrazoado	réplica
louvar-se	repousar
encrencar	rodilhar
desafrontado	desforrado
mazelar	melindrar
alumbrado	deslumbrado
despedaçar	estilhaçar
borrar-se	emporcar-se
desembrutecer	humanizar
deslombado	espancado
arrefeçar	baratear
afazeres	tarefas
patola	tolo
bufão	farsante
desentravar	desestorvar
embabadar-se	enrugar-se
debandar-se	desbandalhar-se
herança	patrimônio
incisivo	incisor
edificar	instruir
merecimento	mérito
escalpar	funestar
exprobar	glosar
escorrer	exsudar
cabriolar	piruetear
elevar-se	nobilitar-se
apimentado	quente
gatafunhos	gatimanhos
dissidente	sedicioso
caxinguento	fedegoso
corpulento	obeso
discussão	disputa
almejar	piançar
inserir	intercalar
benevolente	bondoseiro
ignominiar	vituperar
escusar	inocentar
encabulação	enleio
coligado	confederado
arriçar-se	encrespar-se
cacho	caracol
irretocável	lapidar
admoestar	escovar
memoração	recordação
aventura	peripécia
guasqueiro	minguado
ripada	zargunchada
enturvar	nevoar
dessimétrico	dissimétrico
palestrar	tratar
abobadar	arquear
estramontado	sanhoso
ladino	tacanho
acostado	parasita
adular	engraxar
forrar	picuar
deslizamento	resvaladura
amarelado	descorado
aldeola	casalejo
crescendo	gradação
abrancar	caiar
samexuga	samexunga
refresco	refrigerante
gogó	nó-de-adão
distensão	entesamento
inacabado	inconcluso
casquinada	motejo
estraçalhar-se	romper-se
enflorescer	resplendecer
verecúndia	vergonha
pesado	tenso
originar	produzir
enredador	maranhoso
escambado	trocado
juízo	reflexão
formigar	pulular
delicadeza	primor
vindicar	vingar
azoada	babaré
amparado	resguardado
agaloar	enaltecer
indefectível	seguro
substanciar	tratar
apara	maravalha
excelsitude	pujança
sotaquear	troçar
pavesar-se	vangloriar-se
desarranjo	enxovalho
sopitado	sopito
aceirar	aguçar
desbotar	emortecer
escape	escápole
alimentar-se	comer
caminhar	ir
andamento	seguimento
melancólico	tristonho
enredear	maçarocar
despropositado	espinoteado
ritmo	som
remontar	restabelecer
passear	universalizar
apaixonado	fanático
garrochar	picar
efígie	translado
lotar	tomar
ver	viver
confraternar	fraternizar
argueiro	pisca
ponto	termo
dicionarizar	vocabularizar
empeçonhado	peçonhoso
lacrimal	lagrimal
analogia	conformidade
descadeirar	rachar
brutalidade	selvageria
apostila	apostilha
bifar	larapiar
traquejar	trenar
garganteado	trinado
marmóreo	marmorino
esmiudar	perscrutar
abanicar-se	refrescar-se
cenoso	forte
surf	surfe
galicisparlar	galicizar
existir	ser
bátega	cordoada
envaidar-se	estadear-se
despejado	despudorado
engrambelar	iludir
bisbilhoteiro	coscuvilheiro
incerto	irresoluto
nebulizador	vaporizador
fátuo	jatancioso
absíntio	absinto
eivar	exinanir
desdenhador	menospreçador
leproso	macutena
esbandalhado	esfarrapado
baldrocado	mistificado
desmedrar	emagrentar
despeçar	moer
estorcegar	estrafegar
paralisar	torpecer
malear	minorar
sectário	seguidor
apoteotizar	glorificar
ocasionar	provocar
adquirir	tirar
adequadamente	propriamente
argumentação	debate
criatura	pessoa
conjugação	junção
decurião	monitor
alagamar	pego
pegado	próximo
deliquio	desacordo
amplificador	aumentador
funcionalidade	funcionarismo
tijuco	tujucal
inatividade	inércia
libação	libame
látego	relho
lusque-fusque	meia-tinta
sacolejo	solavanco
desflorir	fanar
descavar	profundar
rebelde	revoltoso
irrenunciabilidade	irresignabilidade
ádvena	vindoiro
pudente	recatado
moleirão	zorreiro
digresso	excursão
carquilha	ruche
bem-arranjado	bem-parecido
filão	veia
condensante	condensativo
abandonamento	desprendimento
encastramento	entrosamento
convulsionar	rebelar
desavir	incompatibilizar
esguichar	espadanar
automóvel	veículo
aconselhado	recomendado
pombear	pombeirar
degradar-se	desautorar-se
espandongar	romper
astroso	sombrio
anojar-se	nausear-se
alanceado	amargado
postergar	sotopor
apassivante	apassivativo
método	regime
comprometimento	prometimento
dirigente	gestor
despargir	raiar
confuso	esfíngico
revelar	vender
irritação	nervosidade
ímpar	único
desaguadoiro	sangrador
vazão	vendagem
desacostumado	desvezado
preludiar	prologar
privilegiado	único
bacorejar	prever
desdourar	deslustrar
aselha	fivela
providenciar	socorrer
encapotar-se	velar-se
estila	estilha
pancada	pulsação
gatunhar	palmear
maceração	tortura
devotamento	entrega
agasalho	pousada
acastelado	coacervado
encorujar	mirrar
deserção	transfúgio
envolvimento	sedução
carcomer	devorar
agricultura	lavragem
desprender	exalar
embaucar	embromar
algibe	cacimba
bobeira	tontaria
sublimidade	superioridade
alienar	desvariar
aglutinar	pegar
descaso	displicência
cognominador	denominador
desafabilidade	malcriadez
glomerar	lotar
pesar	pungimento
condescender	transigir
desenfeitado	desguarnecido
compatibilidade	equivalência
germanar	igualizar
purpurejar	vermelhejar
coadunar	convir
ruidar	rumorar
poente	pôr-do-sol
esquerdo	estouvado
amoldado	moldado
indisciplina	inobediência
diligente	expedito
radicela	raigota
escuso	suspicaz
descodificar	traduzir
enfrutecer	frutescer
abarrotamento	atafulhamento
desconhecido	mal-agradecido
espezinhado	menosprezado
copiosidade	excessividade
peraltar	trasguear
pastio	pasto
segurar-se	suportar-se
preparar	urdir
demorar-se	retardar-se
cicioso	sussurrejante
choramingo	lacrimejamento
espiritualmente	mentalmente
cevado	gordo
coleção	compilação
encabeçamento	prefácio
suster	ter
querenar	recuperar
misterioso	obscuro
afortunado	fasto
reservatório	tanque
fundido	liquefato
casticação	importunação
demonstração	prova
confirmar	verificar
inércia	mandriice
comutação	volta
espertalhão	sabido
beirar	brolar
bordoada	maçada
cabotagem	costeio
cacetada	cachamorrada
corroborar	demonstrar
afagar	mimar
conhecedor	sábio
contíguo	propínquo
declivoso	teso
aclimação	aclimatação
compungir-se	enternecer-se
demanda	discussão
utensílio	utilidade
anemizar	fragilizar
inaugural	inicial
geoclimatérico	geoclímico
chamuscar	crestar
entressemear	recortar
desbloquear	desentulhar
semicerrado	soaberto
catálogo	elenco
apiedado	pio
aferretoar	agulhar
altivez	potra
desbancar	suplantar
peregrino	vindiço
contrafazer	sobnegar
inutilizar-se	ir-se
anglomaníaco	anglômano
expedito	lesto
relumar	tremer
romanticismo	romantismo
enevoar	sombrear
esborrachar	esmurrar
atarantadamente	tontamente
râncio	ranço
epístola	missiva
palpabilidade	tangibilidade
ensangüentar	purpurear
seguir-se	superpor-se
leme	mando
desforço	saldo
ácido	picante
desprimoroso	mazorral
importunar-se	incomodar-se
delombar	dominar
irrecusabilidade	irrefragabilidade
fundir	prodigalizar
empiscar	fulgir
retirado	solitário
embargo	obstáculo
calor	queimor
trilha	trilho
bramir	explodir
chacotear	zombar
vexador	vexante
desencarcerado	solto
cimentar-se	firmar-se
desvigorar	quebrantar
deão	decano
desabusar	desiludir
abas	adjacências
desafaimar	embuchar
costumário	freqüente
doméstica	serviçal
virente	viridente
formidável	magnífico
favorável	pertinente
insurrecto	revoltado
condecoração	honraria
gracioso	serelepe
chumbar	ligar
viandante	viandeiro
septenário	setenário
boquejadura	cochicho
extinção	obliteração
estenografado	taquigrafado
criança	pequeno
brincadeira	gozação
afrontamento	ultraje
desembaraço	intrepidez
impertérrito	intérrito
impingir	rodilhar
povo	vulgo
evocação	revocação
amunicionar	municiar
arqueável	flexível
atilado	maduro
alonginquar	desunir
sorna	zopo
adepto	prosélito
derrengar	esquadrilhar
desgraçar	desvirgar
litigiar	pleitear
olhada	olhadela
amansar	repousar
tonante	tonitruante
amainar-se	refecer-se
colar	emendar
entufar-se	envanecer-se
egoísmo	filáucia
dessecado	insensível
duro	forte
empolgado	seduzido
intacto	intato
grazinar	resmonear
fogosidade	impetuosidade
lampadário	lustre
madornento	sonolento
barateado	regateado
adulteração	adultério
vedação	vedo
descontentar	desprazer
adiantar-se	avançar
estrugir	rebombar
emplacar	enamorar
inquinar	poluir
lastimar-se	vagir
acorrer	lembrar
balouçado	embalado
edule	manducável
desintumescer	detumescer
atordoar	azoratar
acolchetar	colchetar
eminência	saliência
balcão	sacada
demonstrar	reproduzir
avultado	corpudo
cordão	série
denudação	desmascaramento
pífio	torpe
bajulação	louvaminha
abolar	bolear
excetiva	reserva
guardar-se	precautelar-se
efundir	esvaziar
desaprovar	reprovar
fontal	gerador
desembaraçadamente	soltamente
caso	episódio
dissimular	velar
emalar	empacotar
mestre	preletor
acamado	assentado
feiticeira	maga
dirruir	subverter
fender	gretar
sedar	sossegar
recocto	recozido
tenção	vista
acuação	acuamento
suspeitar	ver
azulejador	ladrilheiro
elogio	encômio
divinizar	extremar
pixote	principiante
atormentativo	escruciante
margem	oportunidade
enflorado	florejado
afilhado	apadrinhado
alcance	conseguimento
purpurejante	vermelho
improbar	reprovar
abastança	abundância
descautelado	imprecatado
sobreposição	superposição
refestelado	repimpado
exterioridade	superficialidade
bocejar	oscitar
aterrorizante	fero
explorar	lustrar
carinho	vigilância
queixa	ressentimento
preacada	verdascada
folgazar	jubilar-se
casta	linhagem
pastar	retouçar
dúvida	incerteza
faro	vento
encalhamento	oposição
regozijar-se	ufanar-se
assinalado	ínclito
grupo	tribo
avinhar-se	toldar-se
entesamento	estirão
amulatar	atrigueirar
impalpabilidade	insubstancialidade
careteiro	mogangueiro
angustiar-se	apoquentar-se
insignificância	poucachinho
negrejar	pretejar
erguer-se	suspender-se
apojar	tufar
abençoadeiro	benzedor
algozaria	selvageria
desarrazoadamente	incongruentemente
ardume	queimor
desautorar	rebaixar
arvorado	içado
absenteísmo	abstencionismo
cólera	cólera-morbo
irritar-se	repruir-se
deprimente	humilhante
iminente	impendente
amedrontador	arrepiante
sabugo	tamboera
adicionamento	aumento
seguimento	subseqüência
disgregar	escindir
assiduamente	reiteradamente
noivos	recém-casados
revendão	revendedor
escolha	indicação
aljofarar	esborrifar
encapetado	trêfego
jatar-se	picar-se
encorajar	reerguer
enlace	união
olaria	tijolaria
biliteral	bilítero
recriminar	repreender
lambareiro	lambaz
apreciado	avaliado
cascavel	chocalho
farpão	fisga
decididamente	resolutamente
afundado	escavado
disputar	triscar
reguingueiro	rezingueiro
acostar	coser
determinador	determinativo
engomadura	gomagem
abrir-se	dilacerar-se
atrelar	vencer
aplainar-se	igualar-se
potra	sobranceria
pimpão	sécio
espigar	prosperar
insurreição	motinação
mostrar	pontar
amestrado	ensinado
devastação	razia
dureza	intransigência
autoritário	sentencioso
encafurnar-se	refugiar-se
prega	ruga
folhedo	ramaria
transfigurar	transubstanciar
nevoar-se	obscurecer-se
preênsil	preensor
isomórfico	isomorfo
pospasto	sobremesa
deplorável	ominoso
acoutar-se	aninhar-se
chuvarada	cordoada
desalinhado	mal-amanhado
mascarar	rebuçar
catingudo	caxinguento
competitividade	rivalidade
arrenegação	traição
rebotar	rechaçar
respeito	vênia
destino	sorte
amar	copular
obsedante	obsediante
entreluzir	relumear
acridez	requeime
janotear	pimponar
aro	círculo
deslumbrar	sobrepujar
arremetimento	remetida
afrescar	arrefecer
comiserar-se	condoer-se
ressalto	salpicamento
banguela	benguela
escorço	rascunho
delegado	enviado
inexperiente	novato
enastrar	encanastrar
rebenque	vergasta
alcouceiro	prostibulário
patinação	patinagem
acoelhado	assustado
albor	arraiada
desprezível	pífio
acepção	significado
avisar	premunir
sanado	sarado
overdose	superdose
falsear	violentar
reportar	reprimir
quadrissílabo	tetrassílabo
decair	reclinar
repruir	velicar
delgadeza	magrez
degradação	lama
desamorável	severo
arruinador	prodigalizador
enchouriçar-se	encrespar-se
cerimônia	requifife
estrépito	ribombo
ensebado	sebento
alargar-se	amplificar-se
coato	contrafeito
coleta	colhimento
sabido	tacanho
desdenhoso	imponente
encharcado	paludífero
aquietado	serenado
gemido	plangência
farda	uniforme
acarreto	plagiato
desapropósito	incoerência
tiradura	tiramento
interdição	proibição
expurgar	lavar
desaglomerar	desocupar
abochornador	bochornal
digerir	entuchar
deselegante	indecente
despreguiçar	escordar
absterger-se	depurar-se
barril	vasilha
impudico	sem-vergonha
espirar	odorar
roçar	tangenciar
dito	invencionice
libente	prazenteiro
futucar	zarelhar
gravidade	importância
trança	urdidura
macambúzio	mazorro
infantilidade	parvulez
olorante	perfumoso
fartar-se	repimpar-se
amansar-se	controlar-se
parasitear	sugar
ençampar	velhaquear
babugem	quiquiriqui
incomodar	torrar
finório	maquiavélico
distribuir	ordenar
dupla	par
adornado	ataviado
abnuir	recusar
ressurgir	tornar
enrenquear	perfilar
boato	voz
saída	venda
defesa	discurso
abrasar-se	eletrizar-se
arredar	desconchegar
consumação	realização
adulador	zumbaieiro
encadeação	união
cabrum	caprum
distância	intervalo
carminar	esfoguear
insubordinável	rebelde
amachonar	amachorrar
aguardar	atender
aveludado	veludado
comercialização	extração
lucilar	prefulgir
azulíneo	azurino
finito	limitado
dirigir-se	rumar
colocar-se	pôr-se
imanar	imantar
clarear	diminuir
alvorotar	regozijar
fadário	fortuna
vampirar	vampirizar
cegueira	fanatismo
subjugar	trancafiar
condizer	harmonizar
popularidade	publicidade
avinhar	embebedar
destinação	utilização
tardo	vagaroso
abarrotar-se	cumular-se
cesto	patiguá
jeca	matuto
pacificar-se	quietar-se
desamor	quietismo
critério	roteiro
imergência	submersão
desacautelar	desguardar
compreender-se	perceber-se
vasqueiro	zâimbo
balsamizar	embalsamar
roço	soberba
azagaia	zagaia
ensejo	hora
desmensurável	imensurável
aparato	ostentação
pelejador	rixoso
recua	recuamento
despatriado	êxule
esparzir	lançar
desdobrado	distribuído
apitar	ciciar
pervencer	vencer
adjugar	descativar
glorificador	glorificante
cruento	sevo
senadoria	senatoria
acionário	acionista
descuidado	irreflexivo
encarreirar-se	rumar
assenhorear-se	senhorear
binar	biscantar
independente	livre
aureolar	circular
adiar	espacejar
desfaçatez	safadeza
negar-se	recusar-se
cabeceira	manadeira
descarrilar	desmiolar
rodoiça	rodouça
ocasionar-se	sobrechegar
desconjurar	varrer
perfazer	vencer
escusação	razão
carteamento	correspondência
cassar	resilir
prender	represar
mercadejar	trafegar
abre-ilhós	saca-bocado
copo	taça
caraolho	olhizaino
díade	par
mal-educado	mazorro
desanimador	desconsolador
descumprir	violar
esposar	professar
caçoar	satirizar
mulher-homem	mulher-macho
erijar	inteiriçar
abaloado	pando
abobalhar	aparvalhar
depor	largar
choque	encontroada
dedurar	revelar
abastardamento	bastardia
atenuar	suavizar
espaçar	vastar
notificar	participar
encavalgar	montar
desinfeccionar	desinfecionar
estigmar	notar
desenxabidez	insipidez
pacificar	sedar
refreado	retido
acarar-se	olhar-se
pressagiar	prognosticar
assoberbar-se	desvanecer-se
terminologia	vocabulário
embotelhar	engarrafar
aguaçal	paul
proscrever	sentenciar
desempregar	dispensar
fino	gracioso
acurvar	dobrar
borriçar	pingotear
objetar	remenicar
desaquecer	refecer
carta	diploma
exsurgir	levantar
desestruturar	destruir
anoitecer	noitinha
maçada	tacada
linguarejar	palrear
danar-se	espinhar-se
relumear	tremular
desacordante	desconcordante
brincado	engalenado
circotelúrico	circoterrestre
arrojamento	dardejamento
apegado	pegado
apavorador	aterrador
adventício	estrangeiro
feriado	folga
acepilhado	polido
arrastrar	impelir
amplificar	delongar
mobilizar	soltar
feitiço	malefício
acautelar-se	resguardar-se
crocitar	gralhar
ensecar	exaurir
coirela	courela
empestar	infecionar
lesar-se	marcar-se
transferência	transladação
estorricar	torrar
arrepiar	eriçar
barrica	vasilha
acogulado	atulhado
primar	ressaltar
barquear	barquejar
chupa-sangue	parasito
feminil	inviril
grã-ducal	grão-ducal
cruzar-se	entrecruzar-se
através	transversalmente
imerecido	indébito
drenagem	escoadura
igualar	respaldar
quebramento	violação
hidatígero	hidátulo
abjudicador	abjurgante
atributo	qualidade
aglomerado	coacervado
chilrar	pipilar
desarvorado	desvariado
cuia	porongo
preguear	repanhar
meticuloso	pávido
prestacionar	subvencionar
restante	sobejo
bongar	vigilar
experimentado	matraqueado
enviçado	fresco
encarrascar-se	toldar-se
exigüidade	insuficiência
corruptivo	corrupto
calcamento	esmagamento
debelar	forçar
desproporcionado	desproporcional
mosleme	muçulmano
dissipar-se	extinguir-se
entornar-se	esparzir-se
ermita	ermitão
amiseração	autocomiseração
divertido	folgaz
desengraçado	insípido
desinchar	detumescer
abadiva	badejo
descaminhar-se	esgarrar-se
ensaburrar	ferretar
reforço	revestimento
abiscoitar	arranjar
inextensibilidade	restringência
recuamento	recuo
desembestar	remessar
escaninho	reconditório
adomesticar	domesticar
abortífero	abortivo
observar	tirar
apertado	atribulado
ajoelhado	genuflexo
ingurgitar	pejar
conferir	reverificar
matematicidade	precisão
artificioso	inatural
ligar-se	unificar-se
engrazar	enloisar
resilir	zarpar
manja	tempo-será
escancarar-se	mostrar-se
dobrez	hipocrisia
aura	sopro
arrocho	quê
maltrapilho	trapalhão
fidalgaria	nobreza
autoritarismo	despotismo
açoutar	chibatear
manejo	manuseamento
desarrumado	desorganizado
mero	só
denominar	tachar
dom-quixote	quixote
concatenado	engranzado
doce	melieiro
responsabilidade	segureza
espelhento	luminoso
exilar-se	exular-se
costa	encosta
amimar	berçar
correr-se	pejar-se
grito	reivindicação
avidez	insaciabilidade
atendível	cabível
inevidência	permistão
intervalo	lacuna
pôr	submeter
serração	serragem
atroar	desatremar
bisonho	principiante
descarregar-se	esvaziar-se
abolição	revogação
enfraquentar-se	quebrantar-se
cupom	tíquete
benfazente	favorável
parvuleza	puerilidade
atacoado	atamancado
embrumar	nublar
escambichar	rachar
perfeiçoar-se	requintar-se
reedificar	reerigir
brocar	lurar
firmação	fortalecimento
meninote	mocinho
burlador	logrativo
chilreante	golelheiro
apreender	desconfiar
covarde	pusilânime
remoela	trote
endentar	entrosar
contactar	tocar-se
textura	trama
emburrar	embuziar
enricar	enriquecer
incrementação	lapidação
ajeitado	ordenado
hiemal	invernoso
esporar	prurir
produtividade	rendimento
confundir-se	intermisturar-se
catarata	salto
cenosidade	impureza
categoria	posição
compassividade	condolência
arrolado	enovelado
tampa	tapador
gázeo	verdoengo
rebrilhoso	resplandente
descrever	retratar
abreviar	precipitar
despique	saldo
consertar	medir
acanhar-se	embaraçar-se
acariciante	fagueiro
clamar	requisitar
estontear	zonzear
abichar	pilhar
prevenir	resguardar
amasio	mancebia
atrofiador	atrofiante
execração	raiva
embaimento	embófia
masculinizar	virilizar
contratante	empregador
assinalável	notável
predisponência	veia
envanecer	inchar
vadio	vagamundo
prefação	prelúdio
alquebrar-se	exaustar-se
tremular	trepidar
despossar	trosquiar
fanfurrião	farofeiro
fatiota	indumento
abemolar-se	afetar-se
processo	técnica
azorragada	lamborada
depreender	penetrar
emborralhar-se	nodoar-se
carrear	transportar
periódico	rítmico
emitir	mencionar
desbandalhar-se	disparar-se
encoirar	encourar
comunicação	diálogo
confissão	desabafo
calendário	cronograma
esbulho	espólio
americano	norte-americano
favorecer-se	prevalecer-se
agachado	alapardado
tapeação	velhacaria
estropiador	mutilador
maldadoso	malicioso
garrulice	parolice
aproximar	conjungir
gomo	pimpolho
everter	soçobrar
anestesiar	narcotizar
consorciação	consórcio
prefulgir	relumear
bangular	pervagar
hombridade	virtude
fantochada	fita
saltear	unhar
fatídico	fatiloqüente
criticar	funestar
redargüir	retorquir
interpresar	tentar
delegação	representação
embaular	esconder
interromper	sustar
capela	grinalda
mamantão	mamão
derrotado	vencido
bruxo	necromante
rodopiar	volutear
debulha	defraudamento
afamiliado	maridado
divertimento	entretimento
impenetrabilidade	imperceptibilidade
aladeirado	enladeirado
abastado	ourudo
superestrutura	superstrutura
aquinhoar	prover
golada	trago
musicalidade	unissonância
assombração	assombro
glutonaria	voracidade
prestes	veloz
bom	competente
gatunagem	rapina
cortante	lacerante
brejeiro	tunante
impender	pertencer
afarelar	desmiuçar
ananicado	calhorda
cogitabundo	cogitativo
esfriar	ter
amorosamente	ternamente
decompor	putrificar
elite	nata
açacalado	acicalado
recamar	vestir
baguncear	fandanguear
abaladura	abalamento
bazofiador	pimpão
encandear	ofuscar
contumelioso	ofensivo
concreto	definido
zopeiro	zopo
esfacelar-se	rebentar-se
amesquinhador	apoucador
frívolo	oco
mandriar	mandrionar
descrente	descrido
corrupto	ruim
melhor	preferível
angústia	sofrimento
alambrado	aramado
deambulação	passeio
reinação	safadice
decoroso	reto
corográfico	ctonográfico
fugaz	momentâneo
titubação	titubeação
batueira	tamboera
fervilhar	pulular
sujeição	timidez
fila	linha
capiongo	juruju
desachegar-se	separar-se
volantim	volatim
açaime	açame
desatencioso	inamável
castigar-se	penitenciar-se
embelecar	entreter
acordamento	excitação
mau	mísero
noute	véu
ameninar	renascer
arrebito	imodéstia
pico	zingamocho
lentejar-se	orvalhar-se
corvejar	grasnar
islamismo	muçulmanismo
comuníssimo	vulgaríssimo
criação	ideação
aurifulgente	aurisplendente
absorver	gastar
levantamento	motinação
clérigo	eclesiástico
antever	presumir
agafanhar	unhar
longamira	óculo-de-alcance
açucarado	dulcificado
defumadoiro	defumador
tapeador	tunador
ababelar-se	unir-se
recongraçar	temperar
tabefe	trolha
confessar	revelar
petima	petume
desabridamente	rudemente
desacatar	descumprir
enguiçado	macutena
imolador	sacrificante
abastar-se	aperceber-se
revoltear	revolver
resmungão	rezingão
moderador	moderatório
apetecível	convidativo
eco	retumbo
desnuar	desnudar
sarjação	sarjadura
acintoso	maldadoso
enredar	enredear
tema	terreno
espesso	nubiloso
lusitanizar	portugalizar
resolubilidade	solubilidade
dissonoro	malsoante
despentear-se	escabelar-se
lanhar-se	lesionar-se
resolver	servir
omissor	omissório
secador	tedioso
recordação	reminiscência
coarctador	coartador
frenesi	impulso
lento	pesado
desmentido	negado
ádipe	obesidade
enxofrar	irritar
som	toada
desaferrar	soltar
banda	parte
leitão	porquinho
ganância	ganhos
enfreado	retido
negação	negativa
desamotinar	serenar
humilhar	murchar
resumidamente	sumamente
abrasão	esfola
desordenar	enlabirintar
compromisso	obrigação
detonação	disparo
advogado	defensor
nimbo	resplendor
donoso	galhardo
garantir	resguardar
flagrar	pegar
habilitar	instituir
envolvência	hipnotização
alcoice	prostíbulo
enlevamento	rebitagem
predisposição	veia
mocamau	quilombola
chateação	importunação
requestar	solicitar
pactício	pactual
escarrapiçar	pentear
conflagrar	eletrizar
posterior	subseqüente
apinhar-se	enxamear-se
maroto	ribaldo
aluído	desabado
pomada	proa
receptáculo	vasilha
rompedura	rotura
desestatização	privatização
desnobrecer	inferiorizar
depreciar-se	desmerecer-se
ocasional	ocasionário
conciliábulo	conspirata
adulto	crescido
cismar	suspeitar
agarra	agarração
apeçonhar	empeçonhentar
bandeira	emblema
faneco	seco
desacorde	dissonoro
janotear-se	peralvilhar-se
irrefreável	irreprimível
ponta	vértice
fulgência	resplandor
aprumo	sobrançaria
rondão	trapalhada
flagelar-se	lacerar-se
desvanear-se	emplumar-se
degradador	deprimente
bolacha	pitomba
destacar-se	realçar
maquilar-se	pintar-se
desejar	piançar
cérceo	rente
dado	tendente
diurnal	quotidiano
bagaceira	engaço
incitar	mordicar
abstraente	abstraidor
multiforme	protéico
areísco	areoso
tapigo	tapume
tremelear	tremer
ensombrecer	sombrear
contumaz	persistente
desembravecer	desenfezar
rebuço	refolhamento
rebrilhar	resplender
fatiloqüente	profético
engalanar	ornar
campear	pleitear
abodegar-se	sujar-se
castidade	continência
presságio	profecia
abespinhar-se	esturrar-se
reconvir	retomar
atontado	estonteado
fundamentar	motivar
estrondar	estrondear
desposar	receber-se
entremeter	intermediar
circunspetamente	gravemente
quadripartido	quadripartito
detectar	distinguir
transbordamento	vertedura
chofer	motorista
encorpado	massudo
trinado	trino
desenlaçar	desenredar
abonar	oferecer
comando	rédea
molenga	zorreiro
acoitar	acolher
badernista	desordeiro
premeditado	proposital
desalmado	desamorado
atado	preso
formar	nutrir
atroador	atroante
alcançável	conseguível
assento	base
alongar-se	prorrogar-se
inapreciável	inestimável
encolerizar-se	exaltar-se
afundar-se	desaparecer-se
formalidade	requifife
abscindido	estropiado
retoiçar	travessear
castear	reproduzir-se
desvairado	variado
indigitar	sinalizar
esticão	puxada
chavear	fechar
gestor	superintendente
dilaceração	rebentação
bituca	ponta
acolhimento	guarida
desabrolhar	desbrochar
aplanado	chapado
abronzeado	bronzedo
contristação	melancolia
habitado	povoado
folhada	folhedo
murmulhar	rumorejar
pua	torno
embaralhar	enlabirintar
esfarrapamento	rasgamento
interlaçar-se	sobraçar-se
exemplificar	ilustrar
tratante	velhaco
castamente	inocentemente
desinfestação	desinsetização
sobreexceder	transcender
pagamento	salário
enxadrista	xadrezista
chafurdice	sordície
acidente	contratempo
atrofiamento	entrevecimento
desengrazar	desengrenar
abrevar	beberar
brotamento	renovo
nérveo	nervino
babelizar	desajustar
encolerizar	irritar
materialidade	mundanidade
seroso	soroso
retrogradar	retrosseguir
agrado	prazimento
agarração	agarramento
especular	trabalhar
esporear	inflamar
acoimador	repreensor
esconder-se	transpor-se
visível	visivo
abegão	campônio
deslombar	tarear
arrelvar	relvejar
estancar	parar
afixo	segurado
extraviar	pestear
alugar	estipendiar
corroer	erosar
empenhorar-se	fazer
alarvajado	tosco
obnubilar	ofuscar
desautorizado	desmoralizado
ressonar	retroar
abusar	exorbitar
delibar	libar
escandaloso	indecente
instrução	saber
acapelar	fundir
gerenciar	manejar
querelador	quereloso
arquivar	encerebrar
prosaico	prosístico
divulgado	revelado
exímio	preclaro
gracejo	picueta
cariciável	suave
afumar	vaporar
consignar	firmar
escamotar	esponjar
lamúria	ulo
entrevar	ofuscar
redundar	sair
redivivo	ressurrecto
logro	messe
formular	presentar
afligidor	mortificativo
lamaçal	poceirão
balançar	cotejar
encobrimento	recolhimento
desguedelhar	embaraçar
dominação	mando
apaziguador	pacificador
cavilhar	tarugar
presunção	pretensão
escarpelar	esgatanhar
municionar	munir
irritar	torrar
avergar	sofrear
beneficiado	favorecido
descongestionar	desinflar
melindrar	vulnerar
mantilha	véu
refocilar	restabelecer
abodegação	aborrecimento
inatacável	invulnerável
entender	imaginar
encalvecido	pelado
zangalho	zangaralhão
fração	parcela
pampanoso	pampíneo
amedrontante	fero
andadeiro	andeiro
cretino	nenho
apadrinhar	soprar
tontear	transtornar
respingo	salpico
safadeza	safadice
esverdeado	verdolengo
competição	concurso
tempestuar	torrar
afiado	aguçado
emagrentado	mirrado
arreliento	pendenciador
medicar-se	tratar-se
não	negativa
jacular	vibrar
impulso	remetimento
irreflexão	louquice
primaveral	primaveril
engrandecer	qualificar
amealhar	economizar
decorrido	transato
badalar	toar
azangar	incomodar
motinar	revolver
babaquice	tontice
pávido	tímido
carpetar	entapizar
frustrar	gorar
erotismo	sensualidade
somenos	vilão
aveado	azoratado
subsistir	vigorar
crise	tensão
inculcar	patentizar
estanciar-se	gasalhar-se
aluarado	enluarado
maneiroso	namorado
impelidor	impulsor
chavascal	cortelha
fusão	liquefação
pêlo	penugem
enclaustrado	enclausurado
esfomeação	voracidade
calhar	quadrar
jaezar	ornar
domínio	unha
atrasar	lerdear
assombrar-se	pasmar-se
credo	crença
síntese	união
arriscar	expor
menoscabar	rebaixar
desraigado	extirpado
cimo	cocoruto
pesca	piscicaptura
liquidificante	liqüidificante
desengrossar	detumescer
cintilar	fulgurar
garotagem	pequenada
alardar-se	campar
frialdade	gelidez
entregador	tredo
moldurar	ornamentar
parasito	sabujo
pretérito	transcurso
dandinoso	janota
ajorca	axorca
deliciar	lisonjear
infalível	irremissível
demorar	habitar
lavandaria	tinturaria
mancomunagem	tramóia
árabe	mouro
cansável	fatigável
desmerecimento	desprestígio
sacada	sacadela
indiligente	negligente
bloqueio	trava
branqueado	caleado
reter-se	ter-se
repartição	seção
sombrejar	turbar
eclipsar	sombrear
envermelhar	vermelhear
dependente	submetido
dedução	depreensão
convalescer	reverdecer
rodeio	rotação
apedrejado	ofendido
climatério	climático
congeminar	redobrar
caxiri	veneno
inspiração	toque
contrafazer-se	sofisticar-se
irar	irritar
polvilhar	salpicar
palrice	parolagem
reboco	revestimento
coleante	serpenteante
conciliação	reconciliação
fichamento	registro
cenrada	lixívia
chamejamento	chamejo
envaidecer	pavonear
desatravancado	desingurgitado
imperecedouro	perdurável
lacônico	preciso
ponderação	siso
arquivamento	sobrestamento
nutritício	substancioso
encrava	enrascada
imprevistamente	inesperadamente
envalar-se	fortificar-se
cheio	completo
radioso	rebrilhante
encantar	enlevar
frio	gélido
atoarda	balela
coudelaria	haras
impensado	inopinado
opulentar	reputar
devidamente	merecidamente
denodo	desembaraço
retrátil	retrativo
interceptar	pegar
geladeira	geleira
sereno	sossegado
fim	limite
encosto	respaldo
excessivismo	redundância
bizarrear	gabar-se
grassar	propalar-se
tela	trama
balburdiar	confundir
calcanhar	couce
fiscela	mordaça
acantoar	isolar
deprimir	enervar
admonição	escarmento
tradução	transladação
estrovinhar-se	perturbar-se
acirramento	concitação
toireiro	tourista
esvaecer-se	esvanecer-se
adiamento	transferência
esquina	rebarba
redondamente	redondo
alucinógeno	tóxico
aprimorar-se	lapidar-se
atritar-se	desamistar-se
contenção	encerramento
asfaltagem	asfaltamento
bestalhão	boboca
supletivo	supletório
empapuçado	tumefeito
desocupar-se	dispensar-se
empanturramento	enfartação
condimentação	tempero
atrasar-se	deter-se
revivificar	vivificar
curral	estábulo
misantropo	solitário
cumulação	superposição
bambo	lasso
ajuntar-se	grupar-se
cruz	madeiro
recuperação	restauração
engurujar	retrair
alvissarar	dar
ominar	profetar
doudo	tresloucado
gostar	prezar
enunciado	expresso
torpe	vilão
pindobal	pindoval
fundado	fundamentado
discordo	inconsonância
espaventoso	estrondoso
combustão	ignificação
paralisação	travamento
desalentador	desanimador
embrulhamento	ludíbrio
exclusão	expulsão
baldear	golfejar
ocidente	oeste
protelação	retarde
basear	firmar
ajuizado	circunspecto
autarquia	autocracia
reconstruído	reedificado
especificado	minudente
declinação	declínio
desenlace	desenleio
brunido	reluzente
subornado	vendido
abstêmico	abstêmio
nutrimental	nutritivo
carcerar	prear
encafifado	envergonhado
causa	partido
desperdiçar	dissipar
bem-aventurança	fortuna
entrepausa	intercadência
parentesco	sanguinidade
poupança	sovinaria
desaconselhar	despersuadir
ficar	valer
empalidecer	menospreçar
popularizar	propalar
desgraçar-se	perder-se
assobiado	assoviado
encarceramento	reclusão
cunhar	monetizar
acupunctura	acupuntura
imunizar	mitridatizar
dejejua	dejejuadouro
arquear	envergar
papelejo	papelucho
acompleiçoado	acomplexionado
arenga	discurso
lentejar	transcoar
alçada	competência
calçamento	passeio
guiar-se	nortear-se
agigantar-se	gigantear
maravilhoso	mirífico
descomunalidade	gigantez
apatia	frouxidão
assomadiço	irritadiço
amansado	domado
trapaceiro	tuno
desenrascar	desvencilhar
esbroar	esfarelar
caminhador	caminhante
bronquear	trautear
dessangrado	froixo
desfadigar-se	relaxar-se
direcionar	induzir
grita	vozearia
afonsino	velho
refrigerante	refrigério
chamuscada	chamusco
enredadeira	lena
desculpa	indulto
óbolo	pitança
educação	política
montês	montesino
aglutinante	aglutinativo
descoagulado	descoalhado
pensar	refletir
arruaçador	rusgador
bá	pajem
erosar	rafar
bigodear	chalaçar
infletir	refletir
encalçar	traquear
reaver	recobrar
engrinaldar-se	grinaldar-se
despersuadir	tirar
abandono	arrenegação
júvene	moço
estomagar	melindrar
estupidamente	violentamente
emocionante	impressionante
gesticulação	pantomima
olhizaino	zâimbo
desamarrar-se	desunir-se
bambear	esbambear
crispatura	franzimento
desmama	desmame
pilheriar	rir
comodidade	confortabilidade
gafe	papelão
desembaraçar	desestorvar
aportar	desembarcar
lembrança	marca
assédio	insistência
chistoso	gracioso
remir	restituir
fluviano	fluviátil
linguajar	parlar
desencaminhar-se	perverter-se
alardeador	gabador
aporrear	cauterizar
recacau	regalório
obstante	obstativo
lábia	loquacidade
desagregar	desraigar
estala	estrebaria
lenticular	lentiforme
infortunado	malsorteado
apoético	despoético
ajustagem	amoldamento
entulhar	preencher
desagregação	desmembramento
onipresente	ubíquo
reverdecer	verdecer
arrotear	surcar
pontado	ponteado
desabrochar	entreabrir
breviloqüente	sintetizado
inventariação	relacionamento
conceito	opinião
embespinhar	exagitar
babador	babeiro
peguilha	peguilho
meditabundo	meditativo
molhadela	sobrepaga
ressarcir-se	restituir-se
desbordar	extravasar
venéfico	venenífero
infamar	macular
aparelhado	preparado
doma	domação
miudeza	poucochinho
disciplina	matéria
abolsar	crescer
alvorotamento	excitação
crisolar	desbastecer
caseiro	humildoso
alfeire	chiqueiro
discipulado	tirocínio
idiota	palerma
desentranhar	esviscerar
madurecer	subtilizar
sordidez	torpitude
deflúvio	defluxão
embatumado	pesado
causticar	narcotizar
refrescamento	suprimento
uso	utilidade
desabotoar	entreabrir
adequação	correspondência
carreira	trilha
descompassado	enorme
desconcordante	desconcorde
peraltear	traquinar
descanhotar-se	desunir-se
matriz	seio
toar	tocar
dimensão	espaço
impressionado	perturbado
bruxaria	salgação
empatar	enlear
folgazão	pândego
integralizar-se	inteirar-se
pujança	robustidão
rogativa	súplica
derreter-se	suavizar-se
erudito	lido
brioso	destemeroso
pachorrento	vagaroso
azucrinante	importuno
compreensão	depreensão
estabilizar	fixar
indissociabilidade	irredutibilidade
mulher-de-má-nota	prostituta
individualidade	particularismo
lunulado	lunular
miga	rebotalho
clausurar	entaipar
futuroso	prometedor
realizar-se	sair
eliminar	extinguir
balceiro	balseiro
fortuito	impensado
contendente	inimigo
achado	inventado
filhar	filiar
selvagino	silvático
repugnar	resistir
madurar	subtilizar
entojar	flagelar
refazer	remir
abandalhamento	enxovalhamento
elusivo	esquivo
antipatia	desinteligência
extremidade	fim
badalar-se	promover-se
intrigante	mexeriqueiro
serrátil	serreado
encarvoar	enlaivar
sujeitar	vincular
articular	concatenar
pilhador	saqueador
cinza	rescaldo
inveterado	radicado
contusão	lesão
mosaísta	tesselário
malignidade	perversidade
enrolar-se	equivocar-se
determinar-se	empreender
barbárico	bruto
acariciado	ameigado
alhanar-se	aplanar-se
dominador	senhoreador
radiar	raiar
xenofóbico	xenófobo
acipreste	cipreste
estatuto	lei
doutrinar	educar
ensopado	repassado
piorra	pitorra
enfiada	ramal
aclimatar-se	aclimatizar-se
escolhido	selecionado
findar	tornar-se
marchar	progredir
acrescentado	anexado
torpeza	volutabro
arrozal	arrozeira
adinheirar	adornar
bolboso	bulbáceo
cachimbar	esfumear
infactível	inviável
desdizer	retratar
edícula	oratório
medroso	timorato
descoroçoado	frio
fissuramento	gretadura
tasco	venda
premunir-se	prevenir-se
bonito	elevado
engrenagem	engrenamento
arrampado	ladeira
arrebitar	rebater
estrinçar	fragmentar
recobramento	recobro
conspurcação	estrago
risota	zombaria
amolegar	amolgar
letal	letífico
prosear	triunfar
corporificar-se	incorporar-se
esfingético	nebuloso
correia	loro
mangação	moca
distrair	letificar
morte	sobrevida
regorjear	trinar
pinçar	projetar
adiantado	antecipado
choco	dissaboroso
afeiçoado	unido
distender	expandir
inevitavelmente	necessariamente
maranhar	perturbar
choramigador	choramingador
escabroso	fragoso
surgidoiro	surgidouro
abrigadouro	proteção
cismado	difidente
instruir	lecionar
anulador	nulificante
desrabado	rabicó
infundir	insuflar
enviperado	furente
acurrar	enrinconar
deslocação	mobilização
desenvolvimento	prosperidade
macabro	tétrico
esfaquear	estoquear
choramigueiro	choramingueiro
quadrante	setor
encaramelar	solidar
grunhir	resmuninhar
detento	preso
amante	mulher
aclimatação	ajustamento
escritório	escrivaninha
achaque	moléstia
estatelado	imóvel
acondutar	picuar
nadar	tranar
escanelado	escanifrado
radiemissor	radiotransmissor
aparvalhar-se	desnortear-se
furfuráceo	furfúreo
encafuar	entocar
padecer	tolerar
recopilar	resumir
escapulir-se	livrar-se
estilizar	sutilizar
probatório	provatório
teor	tom
sofrimento	suplício
ladroagem	trama
veicular	zabumbar
imperativamente	veementemente
rugir	urrar
lisonjaria	subserviência
pericote	pitote
irar-se	raivejar
destacar	focar
apessoado	bem-vestido
martelar	martelejar
comemoração	festejo
atrancar	empancar
inconstância	variedade
entrouxar	ordenar
casaco	paletó
aforar-se	avocar-se
ascendente	ascensível
coligidor	compilador
tresvariar	variar
enrascadela	quê
marretar	tarear
palmear	tirar
reabilitar	redimir
crucificar	moer
deboche	desregramento
dispersar-se	estourar
ausência	retiro
desencapar	desenfardar
desembaraçar-se	desvencilhar-se
alvorotar-se	virar
indignidade	torpitude
embarricar	proteger
desarrazoado	ilegítimo
junto	ligado
harmonizar	recongraçar
abortivo	baldado
acervo	amontoado
percorrer	perscrutar
atropelar-se	mexer-se
carrapatar-se	grudar-se
escapada	fuga
ajuntado	aposto
moradia	pousada
calafetamento	vedação
acarrar	resfolegar
considerar-se	pretender-se
azorraguear	zurzir
grã	grão
armado	encoiraçado
gozação	graça
retirada	saída
lodeira	lodeiro
alcoranista	muçulmano
encavernar	enlurar
pretermitir	rejeitar
ereção	levantadura
choraminguento	chorão
adminículo	ajudadoiro
descabelar	despentear
arbitrário	discricional
mesurado	reverenciador
abandalhado	amariolado
rebolir-se	sacudir-se
dependurar-se	suspender-se
reprurir-se	revoltar-se
chicle	chiclete
embrandecer	sensibilizar
empecimento	estorvamento
mediania	mediocridade
caro	precioso
deslavar	desmaiar
carreirismo	oportunismo
mutabilidade	ressaca
engatinhar	gatear
fressura	pacuera
desviar	esgueirar
detido	vedado
antecontrato	pré-contrato
absorbente	aspirante
libidinosidade	sensualidade
incompreensibilidade	insondabilidade
pender	reclinar
capuz	chapeirão
barqueiro	catraieiro
disparo	explosão
rudez	xucrice
difamante	maledicente
anoutar	noitecer
vidrado	vítreo
agalegado	rude
toirista	toureador
gostoso	sápido
regueiro	veio
arrrocho	torcedor
embevecido	extasiado
caduco	senil
agregável	cooptável
ferida	pústula
adensar-se	inspissar-se
esbambear	folgazar
aqui	cá
escarranchado	escarrapachado
exercer	experienciar
inquietar	vascolejar
dactiliológico	datiliológico
tramontar-se	transmontar-se
dissectivo	dissetivo
corajudo	foito
retenção	tardada
análise	exploração
acometer	apossear-se
acumpliciar	cumpliciar
enredado	implexo
roer	sugilar
levogiro	sinistrogiro
balbúcie	tartamudeio
bofar	resfolegar
recalcitrância	reincidência
putirão	putirum
maniatado	manietado
brinde	voto
purga	purgante
livre	safo
asperidade	crespidão
borboleteador	borboleteante
troar	trovejar
declamatório	guindado
matar	trucidar
mesquinhez	pequenez
reencetar	retravar
azougado	genioso
equivocar	trocar
majestático	respeitável
ajudar-se	aproveitar-se
desabituado	desvezado
revoltar-se	sublevar-se
dilaceramento	rebentação
permutação	troca
desprestigiar-se	desvalorizar-se
desleal	tredo
arrebentado	moído
fofoqueira	mexeriqueira
tufar	turgescer
autarca	auto-suficiente
prosador	prosista
ambágio	duvidoso
despachar	enviar
mentiroso	potoqueiro
preguiçoso	ronceiro
apragatado	prudente
diversicolor	versicolor
parvo	tolo
clarificar	emundar
desfilar	processar-se
desorganização	desvinculação
revestir	vestir
frege	tasca
abalada	disparada
embutido	encavilhado
revelar-se	testemunhar-se
esculpir	talhar
flectir-se	fletir-se
senso	sentido
insipidez	mornidão
abstenção	neutralidade
descortinar-se	patentear-se
farinheiro	farinhudo
gang	gangue
mancheia	punhado
arrepiado	híspido
nuper-falecido	recém-finado
caldear	liar
aluamento	doudaria
estabelecer-se	fixar-se
conceder	votar
dulçor	mansidão
adiposo	balofo
desatar-se	romper-se
escabreado	exasperado
trejeitar	trejeitear
senhorinha	senhorita
dirígio	tabanagira
chegadiço	metido
baralhar	desordenar
enrascar	tungar
atencioso	desempoado
bem-afortunado	fortunoso
fraldeiro	fraldisqueiro
corruptibilidade	impiedade
consagrar-se	dedicar-se
arrebitar-se	envinagrar-se
ilogia	ilogismo
apartamento	solidão
envelope	involutório
esteio	sustentáculo
escamífero	escamoso
salada	trapalhice
estampilhar	portear
perquirição	procura
obtestar	provocar
pascentar	regalar
reaprendizado	reaprendizagem
embretar	sitiar
desaliar	desunir
advertido	prevenido
enflorar	engalanar
assaltada	saltada
copiar	tirar
trilo	trino
caracterizar-se	especializar-se
harmonizar-se	reconciliar-se
caraterística	singularidade
beberraz	beberrote
alumbrar	clarear
regateiro	vanglorioso
preparado	prestes
açorado	apetitoso
religião	valores
emprisionar	represar
saltarinhar	saltitar
cerco	cinto
comedimento	compostura
cambalear	titubar
pairar	trepidar
lisonjeador	louvaminheiro
amoquecar-se	intimidar-se
morada	pousada
desprevenir-se	facilitar
ajuda	aviamento
pornéia	pornografia
apático	indolente
inculpar	recriminar
gamela	pilheta
presunçoso	vaidoso
casquinha	plaquê
arrebatar-se	encruar-se
doloroso	magoado
tepor	tibiez
desgraça	sinistro
variação	variedade
início	origem
amofinar	golpear
ultor	víndice
desalinho	descuido
modornar	nausear
formal	manifesto
assinado	determinado
apreçante	apreciador
fartar	mantear
bombinha	traque
bandarra	rúfio
perseguir	tempestuar
brutificar	descivilizar
assomo	indício
fixar-se	implantar-se
alevantado	apanhado
abalofar	fofar
acanaveadura	cruciação
tronchado	tronco
alusão	referência
tumular	tumulário
desenodoar	desnodoar
clarão	fulgor
afim	parecido
saltar	transpor
apossar-se	entrar
suplemento	suprimento
árvore	esquema
palanfrório	parlenga
antiformoso	feio
enojar	escoucear
enroscar-se	intricar-se
saliente	saltado
magnata	senhoraço
bentinho	escapulário
robustecimento	tonificação
adornar-se	paramentar-se
associar	vincular
experienciar	vivenciar
obseqüente	submisso
iroso	violento
insônia	insonolência
estipulação	termos
parasita	sanguessuga
minimidade	pouquidade
grimpa	ventoinha
estrompar	minar
pequeninote	pequenitote
depauperação	empobrecimento
amásio	amigo
propor	sugerir
corrigenda	pregação
declamar	reclamar
adereçar	emoldar
atravessado	sinistro
ovado	ovalado
inconseqüente	inconsiderado
tripas	vísceras
presidir	zelar
aclimatado	treito
traquina	ziguezigue
flamante	rebrilhoso
impacientar-se	irritar-se
degolar	jugular
ervadura	voorara
importunado	molestado
ouvidor	ouvinte
desodorado	desodorizado
a-bê-cê	abecedário
desemprenhar	desprenhar
arrinconar-se	encantoar-se
préstimo	proveito
dicotômico	dicótomo
lamentação	lamento
curvatura	dobra
aromatização	embalsamamento
negro	tenebroso
durar	subsistir
bocadinho	pedaço
empedernir-se	incrustar-se
escarnecedor	irônico
atomizador	nebulizador
alcoolizado	embriagado
envergar-se	zumbrir-se
defumar-se	enfrascar-se
pilha	ruma
aparentar	dissimular
emoldurar-se	ornar-se
eminente	ínclito
propagação	sementeira
abafadiço	pesado
baianidade	baianismo
logrador	trapaceador
inacessível	obstruído
assossegar-se	quietar-se
caquerejar	palrear
moleza	suavidade
acapelado	enfurecido
cabouçar	desencavar
ranço	ressaibo
seção	subdivisão
ronca	roncaria
mudadiço	volátil
acabar-se	diminuir-se
comburir	incinerar
tornar-se	transformar-se
agravamento	aumento
bonacheiro	bonanchão
ambrosíaco	sápido
acessão	acrescente
enforcar	esganar
engraçado	facecioso
amolação	zanga
insubordinar	subverter
facioso	sedicioso
agricultor	arvicultor
picumã	tisne
desnudamento	revelação
bulhento	rumoroso
roceiro	tabaréu
alimpar-se	depurar-se
abocamento	encontro
batotar	trapacear
fota	trunfa
empalecer	menoscabar
costumeiro	usual
abóbora	jerimum
defecar	obrar
massacrante	secador
sarrapilheira	serrapilheira
cordagem	cordoalha
começado	iniciado
vadiar	vagabundar
parcela	porção
consternar-se	horrorizar-se
apoio	escora
desanuviar	desembruscar
alvorescer	raiar
consertado	reformado
desmochar	mochar
bancarrota	debacle
privança	valimento
conjectural	hipotético
lentigo	ovo-de-peru
caldear-se	mestiçar-se
adulão	louvaminheiro
culminação	culminância
nocivo	pernicioso
inalheabilidade	inalienabilidade
acarear	carear
levante	sedição
recuperar-se	reparar-se
eliciar	esconjurar
procrastinação	retarde
entrincheiramento	tapigo
louvação	magnificação
deliciar-se	gozar-se
devassidão	libidinosidade
branquejar-se	encanecer-se
magoado	pisado
abuso	contravenção
ultracorreção	ultraurbanismo
acendível	inflamável
fraturado	quebrado
deveras	verdadeiramente
badalejar	tinir
enjoar	entediar
renovar-se	revigorar-se
desatamento	soltura
perene	porfioso
ourar	ourejar
jugular	sufocar
afregulhado	apressado
evadir-se	eximir-se
azumbrado	corcovado
matança	varredoura
cordoada	salseirada
trancar	vencer
enfiteuticário	enfitêutico
mortandade	varredoira
conglomerar-se	somar-se
sanja	valeta
coiro	couro
debutar	iniciar-se
cadeia	corrente
bafagem	zéfiro
desassisar	desjuizar
contido	sofreado
expulsar	expungir
chafurdeiro	porqueira
curva	sinuosidade
livrar	preservar
celebridade	fama
encumear	engrandecer
atristar-se	penar-se
arredio	tresmalhado
arrinconar	enrinconar
palhaço	truão
jubilação	regalo
vindicador	vindicante
protraimento	retarde
desigual	desirmão
explicação	justificativa
descontinuado	incontínuo
lapidar	substanciado
bebido	emborrachado
pisa	surra
dramático	tocante
idilista	quimerista
escalda	escaldão
adufe	adufo
sofisma	torcimento
desnervar	enfraquentar
manteúdo	mantido
desenliçar	estriçar
bacteriano	bactérico
contaminar-se	infeccionar-se
comparação	confronto
mando	rédea
recato	retraimento
emplastrar	entrapar
amolecer-se	embrandecer-se
transluzir	transparecer
chorro	jorro
coador	filtro
admoestador	admonitor
quadrigêmeo	quádruplo
elenco	lista
augúrio	prognóstico
bromar	corroer
milenário	milênio
abonação	louvor
benquisto	estimado
lamuriar	prantear
implicador	implicante
calejado	catuzado
aquartelar-se	instalar-se
ardidoso	cadimo
delongar	diferir
indiscriminado	indistinto
esmondar	sachar
confrangido	torturado
desconsideração	irreflexão
infundiça	infundice
desentibiar	reflorescer
intricamento	obscurecimento
embespinhar-se	rabiar
celsitude	excelsitude
acurralar	encantoar
alinho	esmero
desencobrir	ver
elogiar	plaudir
amuar-se	entufar-se
caiongo	passado
acertamento	transação
acampanar	espevitar
ebuliente	fervoroso
seio	ventre
amuado	embezerrado
intumescer	tufar
dinheiroso	ourudo
deleitar	refocilar
litigável	litigioso
garçotas	plumeiro
acaso	quinhão
guarda	sentinela
corcovo	pinote
compadecer-se	condoer-se
fleumático	mole
invasão	tomada
classificar	pôr
agudar	desembotar
casual	imprevisto
julgar-se	ter-se
transerrano	trasmontano
abra	anco
paridade	similitude
estaquear	mancar
ineficácia	ineficiência
loba	samarra
cachimbo	pito
adultério	burlaria
amarfanhado	amolaxado
septissecular	setissecular
cachaceira	zangurrina
abrancaçado	entrebranco
civilidade	trato
atenção	zelo
netuniano	netúnio
anteriormente	atrás
ócio	ociosidade
exuberar	pulular
remexer	remover
enervador	irritante
gordo	untuoso
retroar	tempestuar
displicente	indolente
enlousar	enviscar
oscilação	vibração
inesquecível	inolvidável
formação	fundação
amigo	unido
cômpar	conforme
pândega	troça
neblina	nevoaça
predominância	predomínio
balanço	sacolejo
espoliativo	espoliatório
quitador	quitante
rascar	unhar
pontual	religioso
cegar-se	lograr-se
destaque	projeção
enlodar-se	envilecer-se
cuidar-se	resguardar-se
cisma	imaginação
aspirado	disputado
conservar-se	vir
resplandecente	resplendoroso
balde	caçamba
malfeliz	malventuroso
confiabilidade	fiabilidade
brigão	briguento
interrogar	sindicar
inepto	palúrdio
codizar	criptografar
açular	prurir
apetecer	satisfazer
esturrar	rugir
bruno	escuro
pernegudo	pernudo
esbanjar	malgastar
despassar	pervagar
descolorir	desmaecer
ufano	ufanoso
abismar	desgalgar
afanar-se	aplastar-se
agigantear-se	gigantear
nulo	ridículo
isocromático	isócromo
inalar	tomar
impendente	instante
encanutado	tubulado
amalucar-se	endoidecer-se
intencionar	maquinar
apodrecer-se	transviar-se
suspeição	suspeita
faccionar	insubordinar
aparvanhado	apatetado
matinar	remorder
juvenilidade	juventude
pesteado	pestífero
potencializar	vigorar
acre-doce	agridoce
escavação	poço
comprido	longo
alcunha	antonomásia
elasticidade	flexibilidade
cobrimento	tapadura
chancelar	timbrar
fundão	pélago
ruim	sinistro
desaparição	sumição
arregoar	sulcar
anatematização	excomungação
inquinar-se	manchar-se
deslassar	laxar
estriar	raiar
conceitar	tachar
afear	desadornar
aridez	aspereza
honestidade	inteireza
alumiado	esclarecido
entusiástico	fervente
desqueixelado	estupefato
monástico	monjal
esquisitice	exoticidade
entronização	exaltação
embebimento	infiltração
girante	rotativo
ressurrecto	ressurreto
baderna	caterva
controvertível	disputável
abelhudice	intromissão
boçal	rude
bambá	bruega
caravana	tropa
badulaques	cacaréus
faixa	ligadura
boquejar	difamar
adoudado	destrambelhado
molhe-molhe	zimbro
censura	raspanete
atufar-se	meter-se
orfanar	tirar
consonante	cônsono
arrebanhador	pegureiro
enroupar-se	velar-se
bizarria	gala
mascar	murmurar
aditamento	adjeção
trato	uso
febril	pirético
conspurcar	manchar
incompatibilizar	inimizar
escarafunchar	examinar
aresteiro	jurisprudente
chegada	tornada
concitação	incitamento
ardência	caldeação
cambapé	gambérria
alquebramento	debilitação
dessangrar	exaustar
faiscar	relampadejar
guri	menino
marroaz	teimoso
insultar	ofender
sopitar-se	soporizar-se
infeto	podre
formicação	formigamento
embravear-se	esquentar-se
inexperto	novel
baldo	carente
contristado	pesaroso
inchar-se	vangloriar-se
tirânico	tirano
recolocar	repor
emulação	estímulo
fosso	rego
apurativo	detersório
insular	isolar
acatitado	aperaltado
aboleimar-se	achatar-se
chorrar	golfar
esparramo	pega
carapuça	gorro
instalar	receber
cinerício	cinza
descobrimento	desnudamento
elaboração	preparo
indefinição	vacilo
atribulado	doloroso
arquitetônica	arquitetura
exonerar-se	isentar-se
fumo	petema
entrouxar-se	refugiar-se
ímprobo	operoso
vesgo	zanaga
bramar	toar
abstrair-se	separar-se
mouro	sarraceno
dementado	insano
circuitar	envolver
iniciar	prelecionar
curvetar	espinotar
traduzir	transladar
sorrabar	titilar
cafifice	cafifismo
campaniforme	campanuláceo
redistribuir	remanejar
circo	círculo
abalar-se	impressionar-se
descer	desmontar
derruir	desmontar
engrenamento	entrosagem
rusgar	testilhar
mandinga	salgação
minuir-se	moderar-se
doirado	dourado
antes	mais
emurchecer-se	murchar-se
gingar	palhetar
desgalhar	desramar
asilar-se	hospedar-se
albergado	instalado
leigo	profano
expediente	recurso
lateral	travesso
empegar	mergulhar
decote	degolo
agremiar	ajuntar
extremar-se	sublimar-se
jovializar	letificar
disjunção	exarticulação
polposo	toroso
códex	códice
reminiscência	retentiva
desenganar	despersuadir
devassa	sindicância
impedição	veda
indefeso	inerme
espargido	vertido
quimera	vagueação
onzeneiro	usureiro
escachar	fender
carência	míngua
intender	superintender
aplausos	palmas
gambeteador	gambeteiro
cuvilheiro	mexeriqueiro
aperfeiçoar-se	requintar-se
borracheira	embriagamento
desencrespar	pacificar
berregante	clamador
apressurar-se	mexer-se
lustrar	palpitar
quebrar	saracotear
cilindroforme	cilindróide
interlinear	sublinear
bichado	empedrado
estíptico	estítico
qualidade	superioridade
ranchinho	rancho
abduzir-se	afastar-se
jugo	vassalagem
guarda-chuva	umbela
cauíra	mesquinho
enxurrada	reponta
desconsiderar	espezinhar
incessibilidade	intransferência
baque	colisão
tumescência	turgidez
esterqueiro	monturo
saibrar	surribar
indecorosidade	torpeza
rolar-se	sacolejar
fictício	fingido
vista	visualidade
badernar	fandanguear
mascateação	mascateagem
galhardo	garboso
engaiolar	ferrolhar
argüição	imputação
glossário	léxico
aleive	refalsamento
descerebrar	despropositar
aplainar	laxar
euforia	júbilo
lantejoilar	lantejoular
friccionar-se	roçar-se
alogia	disparate
deslado	rumo
obstar	travar
dissaborado	sensabor
derruído	desmantelado
colorar-se	rosar-se
conciliar-se	engraçar-se
carambolar	engabelar
casa	residência
calista	pedicuro
artista	sonso
arribadiço	estrangeiro
perda	traspassamento
autorização	beneplácito
alquebrar	sangrar
ameigar-se	diminuir-se
assimétrico	dissimétrico
doideira	doudaria
varja	várzea
antedito	predito
adaptado	habituado
embolorado	mofado
espanejar	espenejar
gana	voracidade
batalhão	rancho
conserto	refazimento
macho	masculino
circunsoante	circunsonante
esfuzilar	prefulgir
desarroupado	despido
inebriar-se	toldar-se
inclusivamente	inclusive
maleabilidade	maneabilidade
profundar	recorrer
espostejar	estilhar
funestar	verberar
deífico	divinizante
remanso	sossego
pretenso	suposto
vágado	vertigem
falecido	morto
utopista	visionário
abscesso	intumescência
cacarecos	petrechos
aclamado	aplaudido
alienista	mentecapto
mato	roça
derrame	trasbordamento
coçar-se	esfregar-se
adurente	queimoso
normal	perpendicular
apartar	remover
gatunar	unhar
banido	refugiado
preste	prestes
acalmação	acalmamento
alforriar	forrar
morfenho	rouquenho
endereçar	enviar
aboiado	aboio
cinzado	cinzento
cinca	cincada
enlambuzar	ensebar
sobrelevar	suplantar
enraivecer-se	raivejar
inquirideira	látego
paisano	patrício
história	tretas
plácito	prazimento
patife	vergalho
contravir	desobedecer
languidez	moleza
reconciliar	recongraçar
iluso	logrado
ir-se	partir
inesitante	resoluto
abarcante	açambarcador
sevícia	subumanidade
angariar	conseguir
agasalhar	velar
abalroar-se	tocar-se
inalheável	intransferível
aparar	tosar
tempestuoso	tormentoso
averdengado	verdeal
aromado	odorífico
despumar	escumar
colocação	ordenamento
açambarcagem	açambarque
capadura	emasculação
silvar	sobiar
afumear	esfumar
semibárbaro	semi-selvagem
abalsar-se	meter-se
boxe	pugilismo
biografia	vida
dissoluto	viciado
exabundância	prodigalidade
adentrar	embocar
apender	apensar
entristecedor	entristecente
cota	cota-parte
legitimador	legitimativo
atracar	garrear
adição	suplemento
fanar	jarretar
aceitável	receptível
fabulizar	petar
charutaria	tabacaria
narcotizar	paulificar
derrama	derrame
complexidade	pluralidade
acaçapar	encafuar
desponderado	irreflexo
agatinhar	gatinhar
exasperado	furibundo
lésbica	mulher-homem
sobrechegar	suceder
intenso	vivaz
espantar-se	surpreender-se
congraçar-se	harmonizar-se
harmonia	música
dissipação	pândega
garabulhar	rabiscar
demineralizar	desmineralizar
empolado	encapelado
amaciamento	amolecimento
epicédio	lamentação
presentar	semelhar
avassalado	submetido
porfioso	renitente
racioneiro	raçoeiro
equívoco	trocado
liceidade	licitude
afeminar	feminizar
desborcelar	esborcinar
recalcitração	tineta
mensalidade	mesada
atopetado	repleto
fogos	foguete-do-ar
portador	vetor
abricoque	albricoque
zanago	zerê
desvirilizar	emascular
chicotada	ripada
confecção	preparo
estripulia	molecagem
galactófago	lactífago
aparente	paralelo
checagem	verificação
descamação	escamação
remunerativo	remuneratório
demonetizar	envilecer
folheiro	latoeiro
bolhar	borbulhar
enfeitar	formosear
estampar-se	patentear-se
desarmado	desmontado
masturbação	onanismo
amorenar-se	tostar-se
ofender	postergar
bojar	crescer
bando	turba
avisado	cauto
altitúdico	altitudinário
boca-rota	boquirroto
abstinência	jejum
garabulho	garavunha
fitar	olhar
acidentário	brusco
sobnegar	tomar
atrasador	retardador
cambalhotar	piruetar
consentir	sofrer
aligeirado	dulcificado
iguaria	petisco
falda	sobpé
descarinhoso	severo
far-niente	ócio
desfarelar-se	esfarinhar-se
novo	segundo
implícito	subentendido
cimério	lutuoso
acidade	acidez
trampolinagem	vigarice
importunação	irritação
infecundo	infrutífero
ética	valores
encalejar-se	incrustar-se
remelexo	requebro
octogonal	octógono
cacetear	fartar
aromatizado	moscado
acrisolado	cendrado
molambo	trapo
intenção	tenção
celeste	celestial
omnívoro	polífago
fragor	trovão
embaralhar-se	entremisturar-se
espetaculosidade	grandiloqüência
ressurtir	sair
dissecação	dissecção
arremetedor	arremetente
desmerecedor	indigno
rasa	rasoira
enfraquecimento	lassitude
maleficiar	mandingar
cuidadeiro	diligente
fanfarrão	loroteiro
prática	práxis
antipoético	apoético
esterilidade	pouquidão
limnético	límnico
desabilidade	inabilidade
idiotificação	imbecilização
inspetar	lealdar
emudecido	mudo
mourejar	trafegar
estragar	traçar
alhear-se	perturbar-se
imediato	seqüente
balela	boato
assacar	referir
permutador	trocador
desenrubescer	desmaiar
arredondado	boleado
complô	trama
cano	tubo
balnear	banhar
ameninado	menineiro
delimitação	limitação
desarranjar	transverter
cirandinha	roda
coruscante	faiscante
cancioneiro	divã
bodega	cevadeira
desengrenhar	emaranhar
colorir-se	rubescer-se
adocicar-se	amulherar-se
assear	limpar
espirrar	jorrar
fulguroso	nitente
perceber-se	reconhecer-se
dessoante	discordante
deluso	engalhopado
esboçar	idear
risada	riso
aferido	comparado
enobrecimento	notabilização
canceroso	carcinomatoso
gandaiice	sarandagem
recompensar	remir
aformoseamento	aformosentamento
repelir	vastar
próspero	venturoso
lanhar	verrumar
companhia	cortejo
desatado	esparso
circunferência	contorno
malquisto	malvisto
engraçar	reunir
alapardado	recôndito
desenterrar	evidenciar
desagasalho	desamparo
caduquez	decrepidez
fiança	segureza
acelerar	apressar
apoderado	apossado
achanar	alhanar
deturpar-se	putrificar-se
laxação	suavização
gravar	inscrever
gabão	sobretudo
entrave	obstáculo
opiniático	tungador
comperto	descoberto
alourar	enlourar
matéria	tema
dotar	prendar
carga	opressão
embalsamado	olorante
entremesclar	obscurecer
pecunioso	rico
cavacos	sarandalhas
retratar	transverberar-se
acanalar	ranhurar
pregoar	proclamar
braveza	fereza
desguedelhado	esguedelhado
robustamente	vigorosamente
aranzel	cantilena
entremez	sainete
procurar	requestar
proveito	rédito
envenenar	putrefazer
atamento	ligadura
atravanco	estorvo
eximir	liberar
setear	supliciar
ávido	esganado
contraído	franzido
duna	médão
marítimo	naval
preponderância	supremacia
entretido	recreado
grudar	pegar
encantar-se	enfeitiçar-se
aplacar-se	placar-se
estrito	restrito
desnaturamento	distorção
quizila	rota
dobra	sinuosidade
alarvaria	chamboíce
demitir	despachar
muito	sobreguisa
bem-ouvido	submisso
germanado	irmanado
encanzinado	irado
tenso	teso
consulta	pesquisa
manjável	vesco
regalo	regozijo
enfadar	monotonizar
carecer	padecer
remodelagem	remodelamento
liquidação	quitação
baixa	declinação
borraçal	tramolhada
prezar-se	ufanar-se
achamboado	mal-enjorcado
esgotante	extenuativo
atritado	mortificado
madescente	úmido
imane	imenso
arredondamento	harmonização
munganguento	trejeiteiro
cuidado	provimento
maldade	malignidade
afrentar	encarar
reconcentração	união
incubar	traçar
atributado	tributado
levar	portar
furacar	lurar
arredondar	inteirar
ânimo	arrojo
apanhado	levantado
rígido	sólido
chibatar	vapular
entediado	farto
plantar-se	sentar-se
marcador	placar
imprudência	irreflexão
concluído	encerrado
apartar-se	fugir
desborcinado	esbotenado
legal	lícito
entrajar	envergar
tujucal	tujuco
oposição	tope
rever	transverberar
caboclo	caipira
cingir-se	limitar-se
consumo	sumpto
processal	processivo
castiçar-se	copular-se
trava	travação
desobediência	inobservância
meditativo	penseroso
licenciosidade	tripúdio
amanuense	escriturário
códice	pugilar
benemérito	insigne
carrascoso	carrasquento
dissolver-se	exalar-se
soporizar-se	subjugar-se
escusável	supervácuo
aforro	libertação
impudicícia	sacanagem
adonismo	garridice
amigado	cambondo
temerário	venturoso
chavasco	grosseiro
bloquear	proibir
defensora	tutora
fealdade	feiúra
confirmativo	corroborativo
aquerôntico	sombrio
eclodir	ressair
estilhar	estrinçar
desforrar-se	vingar-se
tornejar-se	vergar-se
fronteiro	limítrofe
donairoso	gentil
arquivo	auto
andrajoso	pelintra
alisar-se	aplainar-se
autóctone	indígena
agouro	prognóstico
aromal	fragrante
degenerar	derrancar
meninota	molecota
cavaquista	irritável
exculpação	justificativa
interdizer	vetar
estrebaria	persigal
abrandado	dulcificado
angurriento	famélico
runrum	zunzum
desguarnecer	enfear
lisura	suavidade
mina	tesoiro
desentesoirar	encontrar
precogitação	preparação
xerocopiado	xerografado
aromoso	moscado
apuado	pontiagudo
equivaler	valer
bandada	pelotão
crítico	difícil
cairelar	embainhar
desconceituar-se	injuriar-se
picar	requeimar
encontrar	pegar
frear	moderar
absidado	alcatruzado
balão	esfera
sequioso	sôfrego
percevejo	tacha
sem-vergonhismo	vileza
inlapidado	tosco
acrescer-se	adicionar-se
apalavrar-se	empenhorar-se
nerval	nevrino
sacramentar	ungir
embrenhar	entranhar
agachamento	encolhedela
sestra	sinistra
depauper-se	exaustar-se
isentar-se	livrar-se
bondadoso	bondoseiro
continuado	ininterrupto
alicaído	desacorçoado
lealdar	visitar
jogado	prostrado
adelgaçamento	afunilamento
gauderiar	goderar
abatumado	abetumado
clangor	ribombo
extraviar-se	perder-se
destituir	privar
troçar	trotar
reunir	tomar
aclivoso	enladeirado
lambanceiro	lambeta
contrato	tratado
obstrução	remora
chimarra	samarra
retentivo	retentor
fatura	labor
estremecer-se	gelar-se
embretada	embrulho
endeusamento	potra
relar	roçar
caiporismo	malogro
murmurejar	rugitar
admiração	estranheza
adequar	harmonizar
grilhagem	grilhão
devanear	endoudar
opulento	pomposo
meneamento	oscilação
ressabiado	ressentido
escorregável	resvaladiço
amedrontar-se	estremecer-se
apossear-se	assaltear
isoclinal	isoclino
cavalheiresco	gentil
desvariado	vário
engrupido	escarnecido
refece	soez
endoidecido	enlouquecido
aprendido	decorado
sujeira	tratada
esvaziar	vazar
resmuninhar	rezingar
afogo	atropelação
produzir-se	sobrevir
desorganizar	perturbar
multiface	multifacetado
saboneira	saboneteiro
baia	boxe
colaborar	entrar
predicador	pregador
canastra	lombo
desonrar	ignominiar
desenferrujar-se	desoxidar-se
ressudar	ressumar
banho	lavadura
premir	prensar
inútil	prescindível
diversidade	mudança
amofinado	apoquentado
antealvorar	matinar
afortalezar-se	refugiar-se
daninhar	desmelhorar
apenas	levemente
abarrotar	preencher
ancorado	surto
acrescente	adicionação
veladura	velamento
editorar	publicar
calipígico	calipígio
jura	praga
decifração	decriptação
selar	terminar
desingurgitado	livre
abalado	inseguro
mascotar	mastigar
construção	edifício
esfoguear-se	rosar-se
sordície	sordidez
incipiente	novo
inanição	subnutrição
conformar	harmonizar
salva	subterfúgio
alastrar	inçar
maléfico	pernicioso
sobrolhos	supercílio
labor	lavor
birra	mau-humor
simpatia	sufrágio
amicíssimo	amiguíssimo
desinchado	desintumescido
trazer	vir
chance	deixa
arrasador	assolador
couteiro	montaraz
angustiado	confrangido
empenado	enfeitado
refrativo	refringente
balizar	sinalar
